абсолютнӧй	абсолютный
абу	нет
аварийнӧй	аварийный
авиационнӧй	авиационный
автоматическӧй	автоматический
автономнӧй	автономный
авторитетнӧй	авторитетный
авъя	внимательный
авъя	выразительный
агитационнӧй	агитационный
аграрнӧй	аграрный
агрессивнӧй	агрессивный
агротехническӧй	агротехнический
аддзана	видимый
аддзылӧма	увиденное
адскӧй	адский
азартнӧй	азартный
активнӧй	активный
актуальнӧй	актуальный
алӧй	алый
английскӧй	английский
анонимнӧй	анонимный
античнӧй	античный
арся	осенний
артельнӧй	артельный
арӧса	годовалый
асалан	приватизационный
асвӧляа	добровольный
аскежся	интимный
аслыспӧлӧса	своеобразно
аспом	родной
асшӧр	самостоятельный
асшӧр	частный
асшӧра	самостоятельно
асъядорса	предутренний
асывся	утренний
атомнӧй	атомный
базарбердса	околорыночный
базарвывса	рыночный
базаруйтан	базарный
банкъяскостса	межбанковский
барскӧй	барский
безоговорочнӧй	безоговорочный
белогвардейскӧй	белогвардейский
белӧвӧй	чистовой
бергӧдтӧм	безвозвратный
бергӧдтӧм	невозвращённый
бергӧдчан	поворотный
бергӧдчан	возвратный
берегдорса	прибрежный
бережлив	бережливый
беспартийнӧй	беспартийный
бледпырысь	бледноватый
боевӧй	боевой
бокпӧлӧн	накренившись
болькйӧдчан	булькающий
болькйӧдчана	булькающий
больничаса	больничный
больничнӧй	больничный
большевистскӧй	большевистский
босьтчӧдан	возбуждающий
бригадаса	бригадный
бритчан	бритвенный
бронзӧвӧй	бронзовый
бронированнӧй	бронированный
брусӧвӧй	брусковый
букыд	тяжело
булочнӧй	булочный
булочнӧй	булочная
бур	великодушный
бур	настоящий
бур	здоровый
бур	красивый
бур	высокий
бур	правильный
бурдан	излечимый
бурдлытӧм	неизлечимый
бурдтӧм	незаживший
буржуазнӧй	буржуазный
бурмӧдтӧм	неблагоустроенный
бурӧвӧй	буровой
бурӧвӧй	буровая
бурӧй	бурый
быгъя	пенистый
быгыд	бескровный
быгыдкодь	бледноватый
быддыръя	неотлучный
быдса	целый
бытшкан	колючий
бӧрвывса	задний
бӧрдтӧм	неплачущий
бӧрйысьӧмводзвывса	предвыборный
бӧръя	задний
бӧръя	заключительный
ваа	мочёный
вавывса	водный
вавывса	понтонный
важнӧй	важный
важся	застарелый
вазілля	сырой
валйӧсь	кривой
вапытшса	подводный
варгыль	вихлявый
варгӧс	ленивый
ватнӧй	ватный
ваувса	подводный
вевттьытӧм	открытый
веждӧг	приторный
вежкодь	недозрелый
вежоват	зеленоватый
вежӧра	умный
вежӧртана	разумный
векӧвӧйся	первозданный
веритчытӧм	неуверенность
верктуя	приоритетный
верховнӧй	верховный
веса	весовой
вескӧ	веский
весьлунъя	будничный
видза	приветствие
видзана	охраняемый
видзӧдтӧм	непросмотренный
виж	желток
виж	желчь
вижӧдана	желтеющий
визя	пёстрый
виньдӧдана	обидный
вира	румяный
виччысяна	ожидаемый
виӧма	убитый
воддза	передний
воддза	прежний
воддза	передовой
воддза	ранний
воддза	вводный
водзладорса	передний
водса	горизонтальный
водса	полёгший
военнӧй	военный
вожатӧй	вожатый
вожӧсь	ветвистый
воздушнӧй	воздушный
войся	ночной
войшӧрся	полуночный
вольк	гладкий
вомӧна	поперечный
воронӧй	вороной
ворссьытӧм	беспроигрышный
востер	бойкий
восьса	обнажённый
вочӧжся	годовой
воысь	прибывший
враждебнӧй	враждебный
вуза	продажный
вузалан	товарный
вузалан	продажный
вунлытӧм	немеркнущий
вунлытӧм	безутешный
вуруна	шерстистый
вылысса	менструация
выль	свежий
выліса	верхний
вӧла	подвода
вӧльнӧй	своевольный
вӧлявывса	дикий
вӧрзьывтӧм	немигающий
вӧрзьӧдтӧм	неприкосновенный
гажакодь	подвыпивший
гажтӧмкодь	скучновато
гаруснӧй	гарусный
гежӧдик	реденький
гениальнӧй	гениальный
географическӧй	географический
геройскӧй	геройский
гижӧда	письменный
главнокомандующӧй	главнокомандующий
главнӧй	главный
гожся	летний
гольӧб	колкий
гончӧй	гончая
гортса	домашний
горючӧй	горючее
государственнӧй	государственный
гражданскӧй	гражданский
грамотнӧй	грамотный
граничадорса	пограничный
граничасайса	зарубежный
грузнӧй	грузный
грузнӧй	перегруженный
грузӧвӧй	грузовой
гудыркодь	мутноватый
гудыркодь	тускловатый
гулыд	гулкий
гулыд	яркий
гуся	скрытый
гуся	нелегальный
гуся	интимный
гыа	мятежный
гыда	рысистый
гырнича	корчажный
гырысь	тяжёлый
гӧгӧрвотӧм	недогадливый
гӧгӧрвотӧм	несознательный
гӧдитчытӧм	непригодный
гӧна	ворсистый
гӧна	пушистый
гӧна	махровый
гӧпта	впалый
гӧпта	вогнутый
гӧрба	горбатый
гӧрбыля	согнутый
гӧрд	рыжий
гӧрд	румяный
гӧрдвиж	рыжий
гӧрдов	красноватый
гӧтыра	женатый
гӧтӧвӧй	готовый
дась	начеку
дедъясдырся	дедовский
действительнӧй	действительный
декретнӧй	декретный
дельнӧй	дельный
делӧвӧй	деловой
демократическӧй	демократический
деревняса	деревенский
десятичнӧй	десятичный
десятскӧй	десятский
джуджда	послелог
джынъявтӧм	непочатый
дзерӧдан	нервный
дзерӧдана	нервный
дзолядырся	детский
дзоньвидза	здоровый
дзувкӧс	изворотливый
дзурыд	скрипучий
директивнӧй	директивный
довкӧс	покосившийся
договора	договорный
договорнӧй	договорный
доддя	запряжка
доддявлытӧм	неезженый
должностнӧй	должностной
дона	богатый
донтӧм	малоценный
донӧдтӧм	незакалённый
донӧдтӧм	необожжённый
допризывнӧй	допризывный
дорса	крайний
дошлӧй	проворный
дружелюбнӧй	дружелюбный
дружественнӧй	дружественный
дружнӧй	дружный
дубыд	безвкусный
дубӧвӧй	дубовый
дугдывтӧм	неустанный
дугдывтӧм	неуклонный
дугӧдлытӧм	безостановочный
дудан	норовистый
дудан	застойный
дука	пахучий
дулльӧсь	слюнявый
духовнӧй	духовный
дьӧгӧдя	дегтярный
дэбыд	тёплый
дюж	дюжий
дюж	выносливый
дівывса	островной
дӧверяйттӧм	недоверчивый
дӧвӧльнӧй	довольный
дӧвӧльнӧй	благодушный
дӧзмӧдтӧм	безобидный
дӧзьӧра	ухоженный
дӧмаса	подшитый
енэжувса	поднебесный
жандармскӧй	жандармский
жборган	журчащий
жеб	скудный
жер	оскаленный
жугъя	мякинный
заботлив	заботливый
завиднӧй	завидный
зависимӧй	зависимый
заграничнӧй	заграничный
заднӧй	задний
заказнӧй	заказной
законнӧй	законный
замечательнӧй	замечательный
запаслив	запасливый
зарниа	золотистый
зарубежнӧй	зарубежный
зарядка	зарядка
заслуженнӧй	заслуженный
застой	застой
збодер	бодрый
збодер	статный
збодер	гордый
звукӧвӧй	звуковой
звӧйкъя	цуговой
здоров	полезный
здукся	минутный
зернӧвӧй	зерновые
зондырся	отроческий
зумыд	упругий
зумыд	серьёзный
зумыд	твёрдый
зуркыд	тряский
зэлыд	тугой
зэлыд	тесный
зэра	дождливый
зэра	дождевой
игана	запирающийся
идеалистическӧй	идеалистический
идейнӧй	идейный
идеологическӧй	идеологический
идравтӧм	неубранный
идравтӧм	неприбранный
идӧртӧм	безалаберный
изйӧсь	каменистый
измерительнӧй	измерительный
илӧсь	илистый
именнӧй	именной
инан	ходовой
инасьлытӧм	непоседливый
инасьлытӧм	мятежный
инасьтӧм	непристроенный
индивидуальнӧй	индивидуальный
индустриальнӧй	индустриальный
иностраннӧй	иностранный
интеллигентнӧй	интеллигентный
интереснӧй	интересный
интернациональнӧй	интернациональный
искусственнӧй	искусственный
исполнительнӧй	исполнительный
исправнӧй	исправный
испытаннӧй	испытанный
историяӧдзса	доисторический
ичиньводз	неродной
ичӧтик	незначительный
йиа	ледяной
йӧзкостса	народный
йӧнгыльӧсь	комковатый
йӧёват	глуповатый
кагадырся	младенческий
кадъя	заболоченный
кажитчана	любимый
казеннӧй	казённый
каменнӧй	каменный
кампарнӧй	камфарный
каникулдырся	каникулярный
капиталистическӧй	капиталистический
караульнӧй	караульный
карбердса	пригородный
каркостса	международный
карсайса	загородный
картинавывса	картинный
катаргавывса	каторжный
каторжнӧй	каторжный
квалификацияа	квалифицированный
квартальнӧй	квартальный
керкапытшкӧсса	домашний
кивывса	наличный
кивывся	наличный
кизя	застёгнутый
кийыв	ручной
килограмма	килограммовый
кипода	искусный
киссян	сыплющийся
киссян	осыпающийся
киссян	выпадающий
киссян	распадающийся
киссян	разрушающийся
киссян	заливистый
китрӧй	хитрый
классӧвӧй	классовый
клея	клеёный
климатическӧй	климатический
клящӧй	сильный
коддзӧдтӧм	безалкогольный
коддзӧма	опьяневший
кодзтӧм	некастрированный
кодзула	звёздный
кодзулӧсь	звёздный
козина	подарочный
козъя	еловый
койкабердса	прикроватный
кокньыд	несложный
кокньыдик	лёгонький
кокувса	подножный
колан	желанный
колан	желательный
колан	соответствующий
колана	желанный
колана	желательный
колана	соответствующий
коллективнӧй	коллективный
колониальнӧй	колониальный
кольмӧдана	отравляющий
кольӧм	оставленный
кольӧм	оставшийся
колян	оставленный
команднӧй	командный
комиссионнӧй	комиссионный
коммунистическӧй	коммунистический
комсомольскӧй	комсомольский
комӧка	комковатый
комӧкӧсь	комковатый
кондитерскӧй	кондитерский
конкурснӧй	конкурсный
консервативнӧй	консервативный
контрольнӧй	контрольный
контрреволюционнӧй	контрреволюционный
кооперативнӧй	кооперативный
кормӧвӧй	кормовой
корӧгӧсь	комковатый
кослунъя	постный
космическӧй	космический
коставлытӧм	регулярный
костӧдлытӧм	безостановочный
котырттӧм	стихийный
котыртчытӧм	неорганизованный
кочегарка	кочегарка
краскаа	крашеный
красноармейскӧй	красноармейский
красногвардейскӧй	красногвардейский
краснознамённӧй	краснознамённый
крема	кремовый
крепостническӧй	крепостнический
крепостнӧй	крепостной
крепыд	сильный
крестьянскӧй	крестьянский
кружевнӧй	кружевной
крӧватьдорса	прикроватный
кубӧвӧй	кубовый
кужтӧм	неумелый
кузьмӧс	продолговатый
кузьмӧс	овальный
кузьмӧс	узкий
культурнӧй	культурный
куритчытӧм	некурящий
куркӧвӧй	курковый
куснясьтӧм	несгибаемый
куста	кустистый
кустарнӧй	кустарный
кустъяса	кустистый
куттӧм	беспрепятственный
куттӧм	несдержанный
кывкуттӧм	безответственный
кывлытӧм	неслыханный
кыддза	берёзовый
кыдъя	ломаный
кыдъя	акцент
кызмырдӧна	насильственный
кызмырдӧна	напряжённый
кыка	двойной
кыккостса	взаимный
кыкнанлабокса	обоюдный
кыласа	проглатываемый
кын	мёрзлый
кын	мороженый
кын	сырой
кырымавтӧм	анонимный
кырӧмӧсь	размытый
кырӧмӧсь	овражистый
кӧзяйскӧй	хозяйский
кӧзӧда	студёный
кӧма	обутый
кӧмавлытӧм	неношеный
кӧмӧкӧсь	комковатый
кӧпейкаа	копеечный
кӧрта	железный
кӧртвомавтӧм	необузданный
кӧртӧдтӧм	неперевязанный
кӧрыма	упитанный
кӧтасьтӧм	непромокаемый
кӧтӧдтӧм	непромокаемый
лабутнӧй	размеренный
ласков	ласковый
легкӧвӧй	легковой
лесопромышленнӧй	лесопромышленный
листа	листовой
лиш	нечет
лишалана	избыточный
локтан	предстоящий
ломтытӧм	нетопленный
ломтытӧм	неотапливаемый
лунджынся	полдневный
лунся	дневной
лучкӧвӧй	лучковый
лыаа	песчаный
лымъя	снежный
лысваа	росистый
лысӧй	лысый
лэдзчысьтӧм	настойчивый
лэптана	выдерживающий
ляб	слезливый
ляпкыд	низкий
ляпкыдик	низенький
лёк	скверный
лёк	страшный
лёк	гнев
лёк	грубость
лёк	гной
лётнӧй	лётный
лӧжнӧй	ложный
лӧз	синий
лӧз	синева
лӧсьыдик	аккуратненький
лӧсьӧдтӧм	необработанный
лӧсьӧдтӧм	неприготовленный
лӧсьӧдчытӧм	неуживчивый
лӧсявтӧм	несовместимый
маа	медоносный
майся	майский
максимальнӧй	максимальный
макӧвӧй	маховой
маннӧй	манный
мартся	мартовский
маршрута	маршрутный
масса	масса
мастерскӧй	мастерская
материалистическӧй	материалистический
материальнӧй	материальный
матросскӧй	матросский
матыссаджык	ближайший
медицинскӧй	медицинский
международнӧй	международный
мемориальнӧй	мемориальный
мераа	мерный
мераа	измеренный
меставывса	местный
месткомса	месткомовский
местнӧй	местный
метрическӧй	метрический
механическӧй	механический
миллионнӧй	миллионный
минеральнӧй	минеральный
миритчытӧм	непримиримый
мирнӧй	мирный
мирӧвӧй	мировой
мисаа	слюдяной
мисьтӧм	некрасивый
мичмӧдтӧм	неприкрашенный
многократнӧй	многократный
мобилизованнӧй	мобилизованный
могман	осуществимый
могмытӧм	неудовлетворённый
моднӧй	модный
мойдкывса	сказочный
мольыд	гладкий
мольыд	лоснящийся
монополистическӧй	монополистический
моребердса	приморский
морттуя	разумный
моторист	моторист
мувывса	земной
мувывса	полевой
мугӧм	смуглый
мудзлытӧм	неутомимый
мужика	замужняя
мунтӧм	неходовой
муртавтӧм	неизмеримый
муртӧса	рифмованный
мусаник	миленький
мускула	мускулистый
муспоз	любимый
мутшкӧса	густо
мутӧй	мутовка
муувса	подземный
мывкыд	толк
мывкыд	благоразумие
мылькйӧсь	холмистый
мылькйӧсь	бугристый
мынтысьтӧм	неплательщик
мыссьӧдтӧм	неумытый
мыськывтӧм	нестиран(н)ый
мышка	горбатый
мышкыракодь	сутуловатый
мӧймуся	прошлогодний
нагляднӧй	наглядный
надейнӧй	надёжный
надёжнӧй	надёжный
накажиттӧм	безнаказанный
накӧса	диагональный
нарицательнӧй	нарицательный
национальнӧй	национальный
начальнӧй	начальный
наянкодь	хитроватый
небыд	мягкий
невӧляа	подневольный
негора	негромкий
неграмотнӧй	неграмотный
неджуджыд	невысокий
неджуджыд	неглубокий
недырся	временный
недырся	недолгий
независимӧй	независимый
неколана	ненужный
нелегальнӧй	нелегальный
немортногса	нечеловеческий
немортногса	бесчеловечный
ненога	бестолковый
несправедливӧй	несправедливый
нетыр	неполный
неудачнӧй	неудачный
неурожайнӧй	неурожайный
нильӧг	водянистый
нильӧг	липкий
нимкыла	заговорённый
нимлунъя	именинный
нира	нетоплёный
нитшка	мшистый
нор	грустный
норасьтӧм	безропотный
нормальнӧй	нормальный
нывбабьей	бабий
ныргора	носовой
нырладорса	носовой
нырӧкӧсь	ухабистый
нэмчӧжся	вечный
нэмӧвӧйся	вековой
нэмӧвӧйся	вековечный
нэмӧвӧйся	старый
нэр	слабый
нюжйӧдлытӧм	незамедлительный
нюйтӧсь	тинистый
нюйтӧсь	илистый
нюмсера	юмористический
нюра	болотистый
нюрбердса	приболотный
нюрвывса	болотный
нюрӧсь	болотистый
няръя	перепончатый
нёджӧса	овальный
нёптола	впалый
нӧгыль	густой
обласьтувса	областной
образцӧвӧй	образцовый
общественнӧй	общественный
общӧй	общий
овлытӧм	неестественный
овмӧспытшса	внутрихозяйственный
озъя	земляничный
океансайса	заокеанский
олимпийскӧй	олимпийский
олыся	обитаемый
опыта	опытный
орчча	соседний
ота	широкий
отечественнӧй	отечественный
отхожӧй	отхожий
официальнӧй	официальный
паевӧй	паевой
панаса	вступительный
паныда	встречный
параднӧй	парадный
парнӧй	парный
партизанскӧй	партизанский
парӧвӧй	паровой
пассажирскӧй	пассажирский
пассивнӧй	пассивный
паськыд	широкий
паськыд	окладистый
паськыд	размашистый
паськыд	привольный
паськӧма	одетый
пашкыр	раскидистый
пашкыр	пушистый
пашкыр	кудрявый
педагогическӧй	педагогический
пельк	небольшой
пельк	чистый
первобытнӧй	первобытный
первокласснӧй	первоклассный
периодическӧй	периодический
перкаль	коричневый
перлӧвӧй	перловый
персональнӧй	персональный
перспективнӧй	перспективный
перӧчиннӧй	перочинный
печатнӧй	мерный
печатнӧй	печатный
пивнӧй	пивная
пирожнӧй	пирожное
плавкӧса	плоско
планӧвӧй	плановый
пленарнӧй	пленарный
плодотворнӧй	плодотворный
плодӧвӧй	плодовый
повзьӧдчана	зловещий
подзорнӧй	подзорный
подлиннӧй	подлинный
подозрительнӧй	подозрительный
подоходнӧй	подоходный
подпольнӧй	подпольный
подсобнӧй	подсобный
подъёмнӧй	подъёмный
позорнӧй	позорный
полевӧй	полевой
политическӧй	политический
полярнӧй	полярный
понятӧй	понятой
порядкӧвӧй	порядковый
посникодь	мелковатый
постояннӧй	постоянный
постӧвӧй	постовой
потребительскӧй	потребительский
похвальнӧй	похвальный
почётнӧй	почётный
пошлӧй	пошлый
поштӧвӧй	почтовый
поэтическӧй	поэтический
правительственнӧй	правительственный
православнӧй	православный
праздникводзвывса	предпраздничный
праздникдырся	праздничный
практическӧй	практический
прамӧй	приличный
прамӧй	настоящий
прамӧй	натуральный
прамӧй	довольно
преданнӧй	преданный
предательскӧй	предательский
премиальнӧй	премиальный
преступнӧй	преступный
приданнӧй	приданое
примернӧй	образцовый
принципиальнӧй	принципиальный
природнӧй	природный
приусадебнӧй	приусадебный
приёмнӧй	приёмный
приёмнӧй	приёмная
прогрессивнӧй	прогрессивный
продуктивнӧй	продуктивный
производительнӧй	производительный
производственнӧй	производственный
прокурорскӧй	прокурорский
пролетарскӧй	пролетарский
пропорциональнӧй	пропорциональный
профессиональнӧй	профессиональный
прӧст	пустой
прӧст	вакантный
прӧстӧй	напрасный
прӧстӧй	будний
психическӧй	психический
публицистическӧй	публицистический
пузчужӧм	новорождённый
пуртӧса	бобовые
пустӧй	бессодержательный
пызанвывса	настольный
пыран	входной
пытшкӧсса	внутренний
пӧдраднӧй	подрядный
пӧдса	закрытый
пӧлезнӧй	полезный
пӧлыня	наклонный
пӧлыня	кривой
пӧперега	поперечный
пӧперешнӧй	поперечный
пӧпутнӧй	попутный
пӧрнӧй	взрослый
пӧрнӧй	нестарый
пӧрысь	преклонный
пӧрысь	вековой
пӧрысь	старческий
пӧськодь	тёпленький
равноправнӧй	равноправный
радейтана	излюбленный
радӧвӧй	рядовой
разнӧй	разный
раненӧй	раненый
раса	раса
растительнӧй	растительный
реальнӧй	реальный
регулярнӧй	регулярный
регыдъя	немедленный
регыдъя	недолговечный
рекорднӧй	рекордный
ремонтнӧй	ремонтный
республиканскӧй	республиканский
решающӧй	решающий
розӧвӧй	розовый
ротнӧй	ротный
рубежсайса	зарубежный
рубежсайса	иностранный
руд	серый
руд	русый
рудов	сероватый
рудов	русоватый
ряса	ряса
рӧвнӧй	ровный
рӧдвужа	родственный
рӧдильнӧй	родильный
рӧдъя	рысистый
саженя	саженный
сакарнӧй	сахарный
самодержавнӧй	самодержавный
самодеятельнӧй	самодеятельный
самӧлюб	самолюбивый
санитарнӧй	санитарный
саридзсайса	заморский
свежӧй	свежий
священнӧй	священный
сдельнӧй	сдельный
сдобнӧй	сдобный
сезоннӧй	сезонный
семейнӧй	семейный
сера	резной
серьёзнӧй	серьёзный
сиктса	односельчанин
синводзса	внешний
синводзса	наглядный
синсайса	интимный
синчӧжӧсь	ажурный
сиптӧса	закрытый
складнӧй	связный
скуп	скупой
скӧтнӧй	скотный
славнӧй	славный
сливочнӧй	сливочный
словарнӧй	словарный
сложнӧй	сложный
случайнӧй	случайный
смертнӧй	смертный
собственнӧй	собственный
содтысян	вставочный
сортӧвӧй	сортовой
социалистическӧй	социалистический
социальнӧй	социальный
союзнӧй	союзный
спокой	покой
спокойнӧй	спокойный
спорнӧй	спорный
спортивнӧй	спортивный
справнӧй	зажиточный
справнӧй	исправный
справочнӧй	справочный
средньӧй	средний
срочнӧй	срочный
ставмирса	всемирный
ставроссияса	всероссийский
ставсоюзса	всесоюзный
стандартнӧй	стандартный
старатлив	исполнительный
стариннӧй	старинный
столярнӧй	столярный
страшнӧй	ужасный
субъективнӧй	субъективный
сувереннӧй	суверенный
сувтса	стоячий
сувтса	вертикальный
суевернӧй	суеверный
сунтола	покатый
суткися	суточный
сыктывйывса	верхнесысольский
сьӧдіник	чёрненький
сьӧдіник	чернявый
сьӧкыд	тяжёлый
сьӧкыд	беременная
сьӧкыдкодь	нелегко
сюрсатӧм	беспозвоночный
сюрӧса	хозяйственный
сёрся	поздний
сӧзваа	сочный
тактическӧй	тактический
талунся	сегодняшний
таможняса	таможенный
танквывса	танковый
тапӧ	косолапый
творческӧй	творческий
театрбердса	театральный
телевизионнӧй	телевизионный
термоядернӧй	термоядерный
технологическӧй	технологический
типографияса	типографский
тойӧсь	вшивый
томкодь	моложавый
торжественнӧй	торжественный
торйӧга	разный
тоша	бородатый
тошка	бородатый
трасса	трасса
тугъя	махровый
туйбердса	придорожный
туйвывса	путевой
тулысся	весенний
тулысъя	весенний
тупкӧса	закрытый
тупуа	дубовый
туссьӧсь	пупырчатый
тушаа	рослый
туяна	достойный
тшака	грибной
тшупӧдӧсь	ступенчатый
тшупӧдӧсь	волнистый
тшӧта	чётный
тшӧтшкӧса	ровно
тыбокса	приозёрный
тывборда	пернатый
тылавывса	подсечный
тырмӧса	обильный
тьӧтводз	неродной
тэгъя	сернистый
тілля	болотистый
тільсӧд	болотный
тӧвсайса	подветренный
тӧвся	зимний
тӧлыся	лунный
тӧрскӧба	подмёрзший
тӧрытъя	вчерашний
убыткаа	убыточный
уважлив	отзывчивый
увланьса	низовой
увтаса	низинный
уголовнӧй	уголовный
удачлив	удачливый
удачливӧй	удачливый
уйтыр	подлый
уличвывса	уличный
уллюнъя	скоромный
уліса	нижний
универсальнӧй	универсальный
унма	сонливый
урожая	урожайный
усадьбавывса	надворный
устнӧй	устный
утъя	подошвенный
утъя	подмёточный
фабрикаса	фабричный
фронтвывса	фронтовой
фруктӧвӧй	фруктовый
чаня	жерёбая
чарӧмвывса	настовый
часа	часовой
часӧвӧй	часовой
чергӧдана	сногсшибательный
четвертнӧй	четвертной
чикля	кривляка
чина	чиновный
чирыд	жгучий
читкыля	загнутый
чорпа	неровный
чорыд	твёрдый
чорыд	чёрствый
чорыд	крепкий
чош	настороженный
чужан	родной
чужан	всхожий
чужсьӧг	новорождённый
чукырӧсь	морщинистый
чукӧра	кучевой
чулькйӧсь	бугристый
чунькостса	межпальцевой
чунӧк	чуткий
чуртчӧс	громоздкий
чусыд	тусклый
чуткасьысь	колючий
шав	низкий
шарикӧвӧй	шариковый
шваньгун	улыбчивый
швичкан	трескучий
швичӧг	хлёсткий
швычӧк	гибкий
шепта	колосистый
школабердса	пришкольный
шлипӧвӧй	шлифованный
шлюн	покатый
шлюн	плоский
шмонлив	шутливый
шмоньлив	шутливый
шовинистическӧй	шовинистический
шондіа	солнечный
штатскӧй	штатский
шуда	счастливый
шуйга	левый
шуля	слоистый
шуля	волокнистый
шума	шумный
шыа	звуковой
шыгрӧс	покоробившийся
шыгрӧс	овальный
шыдӧса	крупяной
шыдӧса	рассыпчатый
шылада	мелодичный
шӧрвыйса	средний
шӧркодь	средний
шӧрпӧлӧс	средний
ывлавывса	природный
ыджыд	старший
ыкша	хвастливый
ылӧга	заманчивый
ыргӧна	медный
экономическӧй	экономический
элементарнӧй	элементарный
эмаля	эмалированный
энергетическӧй	энергетический
юбилейводзвывса	предъюбилейный
юдорса	приречный
юйывса	верховой
юмовкодь	сладковатый
юмовкодь	пресноватый
юридическӧй	юридический
юркарса	столичный
юса	речной
юсайса	заречный
ядернӧй	ядерный
ялаа	ягельный
ямскӧй	ямской
ярмангавывса	ярмарочный
ярӧвӧй	яровой
ярӧвӧй	яровые
ӧбиднӧй	обидный
ӧбичаа	высоконравственный
ӧда	быстроходный
ӧдаль	отдалённый
ӧдзлӧс	ходкий
ӧзъяна	вспыльчивый
ӧкаяннӧй	окаянный
ӧктана	наборный
ӧлӧдан	предупредительный
ӧпаснӧ	опасно
ӧстатки	остатки
ӧстатки	последний
ӧталягъя	редкий
ӧталягъя	неровный
ӧтарбока	односторонний
ӧтвесьта	равный
ӧтвывтан	соединительный
ӧтвывтан	собирательный
ӧтка	единичный
ӧтка	единственный
ӧтка	индивидуальный
ӧтка	единоличный
ӧткодь	безразлично
ӧткодь	равный
ӧтласа	общий
ӧтпертаса	однообразный
ӧтпомся	вплотную
ӧтпырся	единовременный
ӧтсӧгласа	солидарный
ӧтчаяннӧй	отчаянный
ӧтчукӧра	кучный
ӧтчыдъя	однократный
абуджык	менее
абутӧма	бедно
аскомысь	послезавтра
аснаукӧн	самоучкой
асшодйӧн	самотёком
баквала	хвастливо
барышнӧ	выгодно
бережнӧя	бережно
бокала	боком
боквыв	на́бок
буждӧдана	осыпая
бурасяна	примиренчески
бурӧн	легко
бӧба	глупо
бӧбмӧмӧн	растерянно
бӧръяпом	наконец
бӧрыннас	наконец
важнӧ	важно
важӧн	давно
вевсьӧн	стопкой
вежлива	вежливо
вежӧгтӧмпырысь	ревниво
велӧдана	внушительно
веритчытӧмпырысь	скептически
вернӧя	верно
весела	весело
виджадӧн	вкось
видзчысьӧмпырысь	осторожно
видзчысьӧмпырысь	сдержанно
визула	быстро
винӧвата	виновато
виш	совсем
воддзаӧн	первым
водзджык	прежде
водзкодь	рановато
вомлала	поперёк
вомӧнӧн	поперёк
востера	бойко
восьлӧн	шагом
выльӧн	вновь
вӧктӧмпырысь	брезгливо
вӧлись	только
вӧлись	потом
вӧляникысь	непринуждённо
вӧсниа	тонко
гажаа	весело
гажапырысь	весело
гажтӧма	жутко
гажтӧмакодь	скучновато
гара	туго
гежӧда	редко
гораа	вслух
гораакодь	громковато
горша	жадно
горӧн	громко
грамотнӧя	грамотно
гудыра	мутно
гудыра	тускло
гулыда	ярко
гылыда	раскатисто
гырыся	крупно
гӧгрӧсӧн	кругло
гӧгӧрпӧв	кругом
гӧлиника	бедно
гӧльпырысь	бедновато
гӧльпырысь	скудновато
гӧля	бедно
гӧнечӧн	бегом
гӧнечӧн	рысью
гӧрдӧдз	докрасна
джуджыда	высоко
джуджыда	глубоко
джынвыйӧ	наполовину
дзескыда	тесно
дзирйыв	настежь
дзольӧбӧн	струёй
дзоньвидзаӧн	благополучно
дивитӧмпырысь	укоризненно
долыдпырысь	радостно
донтӧма	дёшево
дорала	запоем
доролӧн	набекрень
дув	неподвижно
дув	плавно
дузӧба	недовольно
дузӧба	обидчиво
дурка	неуклюже
дышпырысь	лениво
дышпырысь	халатно
дӧсадапырысь	досадливо
дӧсаднӧ	досадно
жалиттӧма	безжалостно
жара	жарко
жеба	слабо
жеба	скудно
жлеча	задиристо
забеднӧпырысь	обиженно
завиднӧ	завидно
зажиточнӧя	зажиточно
заочнӧ	заочно
збодера	бодро
збодера	щеголевато
збыльпырысь	всерьёз
здӧвӧльпырысь	довольно
зумыда	уверенно
зуркыда	тряско
зьвага	брюзгливо
зэлыда	туго
зэлыда	крепко
идӧртӧма	бесхозяйственно
именнӧ	именно
интереснӧя	интересно
исправнӧ	исправно
йӧя	глупо
кальӧба	нервно
кельыда	бледно
кельыда	слабо
кизьӧра	жидко
кикимльӧс	наотмашь
кокниа	легко
кокниа	свободно
кокньӧдана	облегчённо
коланінӧ	кстати
кольыштӧма	остаток
коранаа	просительно
котӧрӧн	бегом
крута	круто
кужтӧма	неумело
кузьмӧса	продолговато
культурнӧя	культурно
курыда	горько
курыдпырысь	горьковатый
кывзысьтӧма	непослушно
кыйкъялана	озираясь
кылан	слуховой
кылан	слышный
кылан	чувствующий
кымынь	ничком
кыпыда	торжественно
кӧлена	потомки
кӧритӧмпырысь	укоризненно
кӧсйытӧмпырысь	нехотя
кӧсӧя	косо
лабутнӧя	неторопливо
лажмыда	мелко
лайкӧдана	убаюкивая
ласкова	ласково
леститчӧмпырысь	заискивающе
лигыша	облегчённо
ловйӧн	живьём
ловйӧн	живым
лунын	днём
лучшӧ	лучше
лывкыда	плавно
лэчыда	остро
люб	добровольно
лючки	благополучно
лючки	внимательно
лючки	аккуратно
ляпкыда	низко
ляпкыда	мелко
лӧня	скромно
лӧсьыда	красиво
лӧсьыда	удобно
лӧсьыда	аккуратно
лӧсьыда	приятно
лӧсьыда	удачно
лӧсьыда	спокойно
лӧсьыдтӧма	некрасиво
лӧсьыдтӧма	неудобно
лӧсьыдтӧма	нехорошо
лӧсьыдтӧма	неаккуратно
манливӧ	затруднительно
мастера	мастерски
матігӧгӧрын	поблизости
методичнӧя	методично
мирнӧя	мирно
мичаа	хорошо
мольыда	гладко
мудза	устало
мудзӧмпырысь	устало
мусаа	мило
мывкыдтӧма	неблагоразумно
мыжаа	виновато
мыжапырысь	виновато
мыжтӧма	невинно
мынтӧдчана	уклончиво
мышкын	позади
мышкӧ	назад
мышладорсянь	сзади
мышладорті	сзади
мӧвпалана	задумчиво
надвое	надвое
надейнӧя	надёжно
накӧсӧн	косо
наперво	только
наянпырысь	нахально
небурысь	сердито
небыдика	слегка
неважӧн	недавно
невернӧ	неверно
невыліті	невысоко
невылӧ	невысоко
негораа	негромко
недыр	недолго
нежнӧя	нежно
неладнӧ	неладно
нелӧсьыда	нехорошо
немкӧ	тяжело
неногӧн	бестолково
непременнӧ	непременно
непременнӧ	несомненно
несмела	несмело
неыліті	недалеко
нивӧю	беспрерывно
нимкодя	радостно
ныжа	тупо
нюжйӧдлана	протяжно
няра	слезливо
ойӧстӧма	беспомощно
окотапырысь	охотно
омӧля	редко
ониша	сонно
ортсылань	наружу
ортсыын	снаружи
официальнӧя	официально
падуйӧн	кувырком
паськыда	широко
патурликӧн	кувырком
пежа	скверно
пемыдӧдз	дотемна
плавнӧя	плавно
подробнӧя	подробно
подӧн	пешком
помвыв	стоймя
помвыв	подряд
посниа	мелко
посниа	убористо
прамӧя	вплотную
пропорциональнӧя	пропорционально
прӧстӧ	просто
пыдӧ	глубоко
пыдӧ	далеко
пырысь	вошедший
пырысь	поступивший
пӧваднӧ	повадно
пӧрадошнӧя	порядочно
пӧшти	почти
ретива	ретиво
решительнӧя	решительно
рӧдйӧн	рысью
сибыда	вежливо
складнӧя	связно
скрипъю	навзрыд
скупа	скупо
слаба	слабо
случайнӧ	случайно
специальнӧ	специально
спокойнӧя	спокойно
сувтсӧн	стоймя
сьӧкыда	тяжело
сьӧкыда	крепко
сэні	там
сэсь	оттуда
сёрӧн	поздно
сідз	так
сідзкӧнӧ	постольку
сӧдза	чисто
сӧстӧма	свято
сӧстӧмӧдз	дочиста
тат	здесь
татчӧ	сюда
терпиттӧма	невыносимо
тешкодя	странно
тожӧ	тоже
томысянь	смолоду
торжественнӧя	торжественно
тшапа	лихо
тшӧга	жирно
тшӧга	сочно
тшӧкыда	густо
тшӧкыда	часто
тшӧтшыда	ровно
тырмытӧма	недостаточно
тюрӧбӧн	струёй
тӧдчытӧма	незначительно
удала	проворно
удачнӧя	удачно
уліын	внизу
урӧда	небрежно
уськӧдчана	угрожающе
честнӧя	честно
чулькйӧн	ключом
чунӧданаа	оглушительно
чусыда	тускло
чӧскыда	вкусно
шаня	хорошо
швальӧн	ливнем
швычӧка	гибко
шольгӧма	крупно
шоныда	тепло
шуштӧма	невесело
шыльыда	слаженно
шӧрипӧв	наполовину
щӧгӧля	щеголевато
ыджыда	крупно
ыкшаа	хвастливо
ылӧкодь	далековато
ыръянвылысь	сгоряча
ышмӧмвылысь	балуясь
эсідз	этак
этшаникаӧн	понемногу
юзӧн	юзом
юмова	сладко
юмова	слащаво
юрӧба	звонко
явӧ	наяву
яръюгыда	ярко
яръюгыда	красочно
ёнпырысь	прочно
ӧбидитчӧмпырысь	обиженно
ӧбиднӧ	обидно
ӧддзӧмвылысь	разгорячившись
ӧдйӧвылӧ	наскоро
ӧкрӧметь	напрасно
ӧні	настоящее
ӧтарвыв	односторонний
ӧтвесьт	наравне
ӧтвесьтын	напротив
ӧтвесьтӧ	напротив
ӧтгудыр	вперемешку
ӧтдор	послелог
ӧтилаті	местный
ӧткодя	одинаково
ӧткӧн	поодиночке
ӧтмоз	наравне
ӧтмоз	поровну
ӧтмоз	однообразно
ӧтмоз	ровно
ӧтмоза	наравне
ӧтмоза	поровну
ӧтмоза	однообразно
ӧтмоза	ровно
ӧтни	беспрерывно
ӧтпыр	однажды
ӧтрӧвнӧ	вровень
ӧтрӧвнӧя	ровно
ӧтчаяннӧя	отчаянно
бринь	брык
бринь	прыг
тив	плавно
а	а
а	а
а	а
а	ба
небось	небось
ӧмӧй	разве
ӧмӧй	неужели
ыз	настежь
абажур	абажур
абзац	абзац
абитуриент	абитуриент
абонемент	абонемент
абонент	абонент
аборт	аборт
аванс	аванс
авария	авария
авиалиния	авиалиния
автобиография	автобиография
автограф	автограф
автоматика	автоматика
автономия	автономия
автопоилка	автопоилка
автопортрет	автопортрет
автор	автор
автореферат	автореферат
авторучка	авторучка
агас	борона
агент	агент
агитатор	агитатор
агитация	агитация
агитпункт	агитпункт
агрегат	агрегат
агрессор	агрессор
агроном	агроном
агротехника	агротехника
агсасьысь	бороновальщик
ад	жадина
адвокат	адвокат
аддзылантор	видимое
аддзысь	зрячий
администратор	администратор
адрес	адрес
азарт	азарт
азбука	азбука
азьлас	острога
аист	аист
ай	самец
ай	отец
айка	свёкор
айлов	мужчина
академия	академия
акация	акация
аквариум	аквариум
аккардион	аккордеон
акт	акт
актёр	актёр
акцент	акцент
акция	акция
аладдя	оладья
алгебра	алгебра
алип	олифа
аллея	аллея
алоэ	алоэ
альбом	альбом
алямазга	неразбериха
амбиция	амбиция
амбразура	амбразура
амортизация	амортизация
анализ	анализ
анкета	анкета
аннотация	аннотация
ансамбль	ансамбль
антенна	антенна
антоним	антоним
антракт	антракт
аплодисментъяс	аплодисменты
аппетит	аппетит
аппликация	аппликация
аптечка	аптечка
арава	орава
арап	арап
аргумент	аргумент
аренда	аренда
арест	арест
арифметика	арифметика
ария	ария
арлыд	возраст
армия	армия
арпи	малёк
артас	расчёт
артасьысь	разборчивый
артасьӧм	счёт
артасьӧм	торговля
артель	артель
артиллерист	артиллерист
артист	артист
артистка	артистка
артмӧмтор	случившееся
архаизм	архаизм
археолог	археолог
архив	архив
архитектор	архитектор
архитектура	архитектура
асвежӧртӧм	самосознание
асдон	себестоимость
аспирантура	аспирантура
асру	странность
ассистент	ассистент
ассоциация	ассоциация
астролог	астролог
астшӧтшъя	ровесник
атака	атака
атаман	атаман
ателье	ателье
атлетика	атлетика
аттестат	аттестат
аудитория	аудитория
аукционер	аукционер
афиша	афиша
аэропорт	аэропорт
аэростат	аэростат
аяныв	золовка
бабьей	бабий
бабӧ	бабушка
багажник	багажник
байдӧг	куропатка
бакен	бакен
балабурда	балаболка
балерина	балерина
баллада	баллада
баллон	баллон
баллотировка	баллотировка
бальӧ	овца
бальӧ	барашек
бальӧпиян	ягнята
бан	лицо
бан	остриё
банда	банда
бандероль	бандероль
банка	банка
банкрот	банкрот
банкротство	банкротство
барабанщик	барабанщик
барин	барин
барка	барка
баруньӧ	барыня
барьер	барьер
бастуйтысь	забастовщик
батарея	батарея
батрачка	батрачка
батьтӧмлун	безотцовщина
башка	башка
башлык	башлык
баянист	баянист
беженка	беженка
безмен	безмен
безобразие	безобразие
бек	бедро
белила	белила
белльӧ	бельё
белянка	белянка
бергавтӧм	неупотребительный
бергач	вертушка
бергач	флюгер
бергӧдлан	вращательный
берет	берет
бертласьтӧм	неподвижный
бертласьтӧм	окостенелый
беседа	беседа
бескӧзырка	бескозырка
беспи	бесёнок
би	пекло
библиотекар	библиотекарь
бигуди	бигуди
бинокль	бинокль
бинт	бинт
биография	биография
бипур	костёр
биржа	биржа
блаж	блажь
бланк	бланк
блокада	блокада
блокнот	блокнот
блюд	блюдце
бобӧнянь	клевер
бог	бог
боеприпас	боеприпасы
бой	бой
бок	бок
бокс	бокс
бокшаин	косогор
болт	болт
больгун	болтун
больк	пузырь
большевик	большевик
бомба	бомба
бор	межа
борт	борт
босоножки	босоножки
босьтчӧм	побуждение
бра	бра
брага	брага
бракольчи	бубенчик
бригадир	бригадир
бричка	бричка
бронгун	пустозвон
броневик	броневик
бронепоезд	бронепоезд
бронеч	бронец
броня	бро́ня
броня	броня
брынза	брынза
брӧдяга	бродяга
бубен	бубен
бублик	бублик
буддизм	буддизм
будильник	будильник
бужӧд	обрыв
бузган	водопад
буква	буква
буквар	букварь
булавка	булавка
булыжник	булыжник
бульдозер	бульдозер
бульдозерист	бульдозерист
бумага	документ
бумажник	бумажник
бурдӧдысь	лечащий
буржуазия	буржуазия
буритчысь	бурильщик
буркыв	проповедь
буркыв	молитва
буркӧсйысь	доброжелатель
бурлун	преимущество
бурсиан	благословение
бурсьылысь	проповедник
бурӧвик	буровик
бутыль	бутыль
бухгалтер	бухгалтер
бушлат	бушлат
быг	пена
быдмантор	растение
быдмасьысь	мотальщик
быдму	вселенная
быдмӧг	растение
былина	былина
бырӧд	наледь
бырӧмтор	утрата
бюджет	бюджет
бюллетень	бюллетень
бюрократ	бюрократ
бӧбйӧдлысь	мистификатор
бӧж	хвост
бӧж	подол
бӧлбан	болван
бӧрйысьысь	разборчивый
бӧрйысьӧм	выборы
бӧркыв	послесловие
бӧртас	результат
ва	отвар
ва	жижа
вабергач	водоворот
важлун	ветхость
важлун	давность
важлун	древность
важолысь	абориген
ваза	ваза
вазелин	вазелин
вайӧм	роды
вайӧм	кладка
валеги	валенки
валежник	валежник
вальді	алебастр
вап	краска
варенньӧ	варенье
варнича	варница
васӧдлун	сочность
ватага	ватага
ватник	фуфайка
вахта	вахта
ваюксянін	водораздел
вевт	навес
вевтасін	суходол
вегыль	червь
ведомосьт	ведомость
вежадыр	святки
вежалун	воскресенье
вежас	замена
вежас	обмен
веждӧглун	приторность
вежласьтӧмлун	однообразие
вежласьтӧмлун	стабильность
вежласьтӧмлун	целостность
вежласьӧм	смена
вежласьӧм	колебание
вежон	неделя
вежыняин	кривизна
вежӧр	сознание
вежӧртаслун	значимость
вежӧрттӧмлун	машинальность
везӧт	сеть
вей	нерв
век	всё
векнилун	узость
вем	мозг
венеч	венец
венок	венок
вентилятор	вентилятор
вера	вера
вера	надежда
веранда	веранда
вербуйтысь	вербовщик
верви	дратва
вердантор	иждивенец
вердас	корм
вердаслун	упитанность
вердчанін	кормёжка
вердчанін	кормушка
веретяин	суходол
верзьӧма	верховой
верктуй	рекорд
веркӧс	кора
веркӧс	уровень
вермытӧмлун	беспомощность
вермытӧмтор	невозможное
вернӧйлун	верность
верстак	верстак
вес	вес
веськыдлун	прямизна
ветеран	ветеран
ветланног	походка
ветьӧк	тряпка
вешалка	вешалка
веялка	веялка
взнос	взнос
взрыв	взрыв
взятка	взятка
видзантор	иждивенец
видзӧг	щит
видзӧдантор	зрелище
видзӧдчан	зеркало
видзӧдысь	зритель
вижъюр	одуванчик
виза	виза
визирка	просека
визлач	быстрина
визувлун	быстрота
визувтӧм	сток
визувтӧм	натёк
визь	ряд
визь	полоса
визь	строка
визьӧб	ряд
визьӧб	линия
визьӧб	контур
визьӧб	очертание
вийӧдӧмтор	отгон
вила	вилы
вилки	вилка
винт	винт
винтовка	винтовка
вирич	рассадник
висьт	рассказ
висьт	известие
висьталӧмтор	сказанное
висьталӧмтор	показание
витамин	витамин
витрина	витрина
витсёа	пятисотенный
вич	отчество
вклад	вклад
вкус	вкус
власьт	власть
внук	внук
внучка	внучка
во	год
водздӧра	передник
водзир	клык
водзладор	перёд
водзпом	начало
водянка	водянка
военкомат	военкомат
вождь	вождь
воз	моль
воздух	воздух
воин	воин
войска	войско
войтӧв	судорога
воклун	братство
волькдыр	гололедица
вом	устье
вон	полог
вопрос	вопрос
воронка	воронка
воротник	воротник
ворс	ворс
ворсантор	пьеса
ворсысь	игрок
воссьӧмин	пролежень
воссяна	складной
востерлун	бойкость
востым	зарница
воськов	шаг
восьсаин	полынья
воторник	вторник
вотулов	поборы
вотӧсаин	ягодник
враг	враг
врач	врач
вуджанін	перелаз
вуджанін	брод
вуджӧдчысь	переводчик
вуджӧдӧмтор	пережитое
вуджӧм	переход
вуджӧм	нарушение
вуджӧм	заражение
вуджӧр	тень
вуз	вуз
вузалысь	продавец
вундӧмтор	обрезок
вурд	выдра
вурсьысь	сапожник
вывкыш	кожица
вывод	вывод
вывтыр	тело
вывтыр	одежда
выговор	выговор
выгӧда	выгода
выигрыш	выигрыш
выйчери	сёмга
выключатель	выключатель
выльлун	понедельник
выльтор	новшество
вын	мощность
вын	энергия
вынсьӧдантор	удобрение
вынтӧмлун	бессилие
выручка	выручка
выставка	выставка
вышка	чердак
вышка	вышка
вӧвйӧн	чертополох
вӧжжи	вожжи
вӧзйӧмтор	предложение
вӧльгым	ноябрь
вӧльд	пороша
вӧрзьӧдчӧм	движение
вӧрпункт	лесопункт
вӧртас	горизонт
вӧртӧмин	безлесье
вӧрӧк	ворох
вӧснилун	тонкость
вӧчасянін	мастерская
вӧчысь	строящий
гад	гад
гадь	пузырь
гаж	веселье
гаж	развлечение
гаж	желание
гаж	надежда
гажлун	радость
гажлун	праздник
газ	газ
газон	газон
газопровод	газопровод
газӧвик	газовик
галифе	галифе
галлюцинация	галлюцинация
галстук	галстук
гангрена	гангрена
гарантия	гарантия
гармонист	гармонист
гарнитур	гарнитур
гартым	свёрток
гартӧд	обмотка
гартӧд	жгут
гастрит	гастрит
гач	шаровары
гежӧдлун	редкость
гектар	гектар
география	география
геолог	геолог
геометрия	геометрия
георгин	георгин
герб	герб
гербарий	гербарий
герой	герой
гигант	гигант
гидростанция	гидростанция
гижанног	правописание
гижанног	стиль
гижтас	написание
гижысь	секретарь
гижӧд	запись
гижӧд	записка
гижӧд	почерк
гижӧд	текст
гильза	гильза
гимн	гимн
гимназия	гимназия
гимнастика	гимнастика
гимнастёрка	гимнастёрка
гинеколог	гинеколог
гипербола	гипербола
гипертония	гипертония
гипноз	гипноз
гира	гиря
гирснитчӧмин	царапина
гирснитӧм	чирканье
гирснитӧм	царапина
гирснитӧм	лязг
гладиолус	гладиолус
глас	голос
глиссер	глиссер
глобус	глобус
гобелен	гобелен
гогын	скобель
гож	загар
гожйӧдчанін	пляж
гожӧм	лето
гоз	пара
гольган	погремушка
гонорар	гонорар
горадзуль	колокольчик
гордосьт	гордость
горзӧм	крик
горзӧм	стон
горзӧм	перекличка
горзӧм	стрекотание
горизонт	горизонт
гормӧдчан	кочерга
горнича	горница
городки	городки
горс	ниша
горчичник	горчичник
госпиталь	госпиталь
градус	градус
граждана	граждане
гражданин	гражданин
гражданка	гражданка
грамматика	грамматика
граммофон	граммофон
грамота	грамота
граната	граната
графа	графа
график	график
графин	графин
грелка	грелка
гривенник	гривенник
грим	грим
грипп	грипп
гроссмейстер	гроссмейстер
грузчик	грузчик
грузӧвик	грузовик
грунт	грунт
группа	группа
груша	груша
грӧш	грош
гу	яма
гу	могила
гудок	гудок
гудрас	раствор
гудрас	паста
гулюпи	голубёнок
гумыльга	водоворот
гумыльга	вихрь
гуран	низина
гуран	лунка
гуран	впадина
гурина	пескарь
гурйыв	настежь
гусь	вор
гусясьысь	вор
гусятор	краденое
гыжли	копытница
гылыдлун	раскатистость
гымалӧм	гроза
гымньӧв	молния
гынкӧм	валенки
гыр	ступа
гырк	туловище
гырксаин	пустота
гӧганыв	внучка
гӧгапи	внук
гӧгрӧс	юбилейный
гӧгӧрвотӧмлун	несознательность
гӧгӧртас	окружность
гӧгӧртас	пространство
гӧлень	голенище
гӧлуб	голубь
гӧлӧвня	головня
гӧнаюр	пушица
гӧнтӧмин	плешина
гӧр	соха
гӧрб	горб
гӧрб	спина
гӧрбыль	горбыль
гӧрддзым	завязь
гӧрдитчантор	гордость
гӧрдлун	краснота
гӧровтас	выбоина
гӧрӧд	узел
гӧрӧд	завязка
гӧснеч	взятка
гӧститӧдантор	угощение
гӧстя	гостья
гӧч	хрящ
дарвинизм	дарвинизм
дарга	пескарь
дарга	ёрш
дарнӧс	проушина
дасьлун	готовность
дата	дата
дача	дача
двор	двор
двореч	дворец
двустволка	двустволка
дед	предок
дежурство	дежурство
дезертир	дезертир
дезинфекция	дезинфекция
дезинформация	дезинформация
дезорганизатор	дезорганизатор
дезорганизация	дезорганизация
действие	действие
декабр	декабр
декада	декада
декан	декан
деканат	деканат
декрет	декрет
демилитаризация	демилитаризация
демобилизация	демобилизация
демократ	демократ
демократизация	демократизация
демократизм	демократизм
демократия	демократия
демонстрация	демонстрация
депо	депо
деревня	деревня
держава	держава
десятина	десятина
десятка	десяток
десятник	десятник
детдом	детдом
детектив	детектив
детина	мальчик
детина	парень
дефис	дефис
деятель	деятель
джодж	пол
джодждӧра	половик
джын	середина
дзебанін	могильник
дзебӧмин	укрытие
дзебӧмин	захоронение
дзебӧмтор	укрытое
дзебӧмтор	утаённое
дзескыдін	теснота
дзескӧдӧм	давление
дзимбыр	дресва
дзирд	блёстки
дзодзув	ящерица
дзодзӧгпи	гусёнок
дзолядыр	детство
дзоньвидзалун	здоровье
дзорлун	седость
дзу	куча
дзугӧс	путаница
дзулля	вертлюг
дзулля	крестец
диагноз	диагноз
диаграмма	диаграмма
диафильм	диафильм
диверсант	диверсант
диверсия	диверсия
дивизия	дивизия
диета	диета
дикар	дикарь
диктант	диктант
диктатура	диктатура
диплом	диплом
дипломатия	дипломатия
дирекция	дирекция
дискуссия	дискуссия
диспансер	диспансер
диспетчер	диспетчер
диссертация	диссертация
дисциплина	дисциплина
дитюк	дитятко
дитюк	голубчик
дневник	дневник
договор	договор
додь	сани
доз	посуда
дой	боль
дой	болячка
доймӧм	боль
доймӧм	увечье
доказательство	доказательство
доклад	доклад
доктор	доктор
документ	документ
долыдлун	жизнерадостность
домино	домино
дон	цена
донос	донос
донтӧмлун	дешевизна
допризывник	допризывник
допрос	допрос
дорвидзӧг	граница
дорйысьысь	оправдывающийся
дорйӧг	защита
дорйӧг	оборона
дорччанін	кузница
дорччысь	кузнец
дорыш	край
дорыш	лезвие
доход	доход
дояр	дояр
драмкружок	драмкружок
драмтеатр	драмтеатр
дружба	дружба
дружина	дружина
дружинник	дружинник
дрӧб	дробь
дубитчанін	дубильня
дулӧ	дуло
дум	желание
дурлун	глупость
духи	духи
духовка	духовка
дуэль	дуэль
дыж	перепонка
дыштор	жилка
дюжина	дюжина
дюжлун	выносливость
дядь	отчим
дядьводз	неродной
дяк	дьяк
дякича	дьякича
дякӧнича	дьяконица
дін	кочерыжка
дӧвалун	вдовство
дӧз	редко
дӧз	досада
дӧз	раздражение
дӧзьӧр	уход
дӧманик	доманик
дӧмастор	заплатка
дӧра	холстина
дӧска	доска
еджыдлун	белизна
единица	единица
ельдӧг	груздь
енэжиз	метеорит
енэжтас	горизонт
епархия	епархия
епископ	епископ
еретник	колдун
еретнича	колдунья
ефрейтор	ефрейтор
жакет	жакет
жальлун	жалость
жалӧба	жалоба
жандарм	жандарм
жанр	жанр
жеблун	скудость
жель	заноза
жеребей	жребий
жертва	жертва
живопись	живопись
жонь	снегирь
жугалӧмин	пролом
жуглӧс	обломок
жук	жук
жулик	жулик
журнал	журнал
журналист	журналист
жыр	комната
жӧлвак	желвак
жӧм	пресс
жӧник	жених
забастовка	забастовка
забой	забой
забойщик	забойщик
забота	забота
зав	заведующий
заварка	заварка
завертка	завёртка
завет	завет
завтрак	завтрак
завхоз	завхоз
загадки	загадка
заглавие	заглавие
заговор	заговор
заговорщик	заговорщик
загс	загс
заданньӧ	задание
задатки	задаток
задача	задача
задачник	задачник
задник	задник
зажигалка	зажигалка
заказ	заказ
закал	закал
закалка	закалка
заклад	заклад
закон	закон
закуска	закуска
залп	залп
замазка	замазка
заместитель	заместитель
заметка	заметка
занавес	занавес
зап	запас
записка	записка
заповедник	заповедник
запрет	запрет
запрос	запрос
заработок	заработок
зарад	заряд
зараза	зараза
заргум	дудник
заслуга	заслуга
засуха	засуха
затвор	затвор
затон	затон
затор	затор
захватчик	захватчик
заём	заём
збодерлун	бодрость
збодерлун	щегольство
збыльмытӧмтор	утопия
зверство	зверство
звӧн	звон
звӧнок	звонок
здоровье	здоровье
землемер	землемер
земляк	земляк
зерносушилка	зерносушилка
зернохранилище	зернохранилище
змейпи	змеёныш
знак	знак
знамя	знамя
зоб	зоб
зона	зона
зонтик	зонтик
зоология	зоология
зоопарк	зоопарк
зоотехник	зоотехник
зорӧд	стог
зубилӧ	зубило
зульӧ	неряха
зуньӧ	копуша
зыбка	зыбка
зывгун	нытик
зывӧк	презренный
зык	шум
зык	вражда
зымвидзантор	громада
зыр	лопата
зыртчӧмин	потёртость
зыртӧмин	потёртость
зырым	сопли
зыряна	зыряне
зяб	зябь
зять	зять
зі	овод
зіб	шест
зӧлӧтник	золотник
зӧлӧтука	золотуха
зӧртусь	бородавка
идеал	идеал
идеализм	идеализм
идеалист	идеалист
идеолог	идеолог
идеология	идеология
идея	идея
идз	голенище
идз	паголенок
идӧг	ангел
изанін	мельница
издательство	издательство
изкар	крепость
измена	измена
изменник	изменник
изобретатель	изобретатель
изобретитӧмтор	изобретение
изолятор	изолятор
изюм	изюм
именник	именинник
иммунитет	иммунитет
империализм	империализм
ин	место
иналун	верность
инвентаризация	инвентаризация
индустрия	индустрия
индӧд	замечание
индӧд	решение
индӧд	указатель
индӧд	наставления
инерция	инерция
инженер	инженер
инним	топонимия
инспектор	инспектор
инспекция	инспекция
инстинкт	инстинкт
институт	институт
инструктор	инструктор
интеллигенция	интеллигенция
интервенция	интервенция
интервью	интервью
интерес	интерес
интернат	интернат
интонация	интонация
информация	информация
искусство	искусство
исследователь	исследователь
итог	итог
ичинь	мачеха
ичӧтдыр	детство
ичӧттор	частность
йиг	таран
йиді	айсберг
йики	ость
йирым	октябрь
йирӧданін	пастбище
йитвеж	застёжка
йитчытӧмлун	противоречивость
йитӧс	цепь
йод	йод
йыв	остриё
йыв	кончик
йыв	наконечник
йӧктӧдантор	плясовая
йӧн	осот
йӧнгыль	луковица
йӧнгыль	комок
йӧр	загон
йӧрдан	прорубь
йӧрдан	иордань
йӧршитӧмин	неволя
йӧрыш	объём
кабалатор	записка
кабина	кабина
кабыр	кулак
кабыр	хватка
кавычка	кавычки
кагадыр	младенчество
кагук	малютка
кадпас	дата
кадр	кадры
кадриль	кадриль
каета	раскаяние
каземат	каземат
казначей	казначей
казначейство	казначейство
казнь	казнь
казьт	воспоминание
казьтыланпом	наследство
казьтылантор	воспоминание
казьтылӧм	воспоминание
казьтылӧм	упоминание
казьтылӧм	напоминание
казявтӧмлун	недогадливость
какао	какао
каланча	каланча
калган	калган
калека	калека
калым	взятка
калькулятор	калькулятор
кальсы	клёст
камаш	ботинки
камаши	ботинки
каменщик	каменщик
камера	камера
камин	камин
камод	комод
кампания	кампания
кампанньӧ	компания
кампорка	конфорка
канава	канава
канал	канал
канализация	канализация
канат	канат
канва	канва
кандидатура	кандидатура
каникул	каникулы
канонада	канонада
кант	кант
кантора	контора
каньпи	котёнок
капелла	капелла
капитал	капитал
капитализм	капитализм
капиталист	капиталист
капитуляция	капитуляция
капкан	капкан
капсула	капсула
караб	корабль
карандаш	карандаш
карантин	карантин
карбас	паром
кардиограмма	кардиограмма
карета	карета
каризна	девичник
карикатура	карикатура
карнан	коромысло
карниз	карниз
карниз	наличник
картеч	картечь
картина	картина
картинка	картинка
карточка	карточка
кассир	кассир
катаник	валенки
катарга	каторга
катаржник	каторжник
катастрофа	катастрофа
категория	категория
катер	катер
катов	наклон
каток	каток
катшасин	ромашка
кафе	кафе
кафедра	кафедра
качай	качели
качество	качество
каюта	каюта
квалификация	квалификация
квартирант	квартирант
квастлун	хвастливость
квитанция	квитанция
кебӧс	сиг
кевманін	молельня
кеж	дерюга
келанін	брод
кельыдлун	бледность
кепка	кепка
кер	лес
керас	вырубка
керӧмтор	изделие
кидас	бесплодный
киллюшка	избушка
килограмм	килограмм
километр	километр
киль	перхоть
кильчӧ	крыльцо
кималас	ощупь
кинжал	кинжал
кино	кино
киноартист	киноартист
кинокамера	кинокамера
кинокартина	кинокартина
киномеханик	киномеханик
киномойд	киносказка
кинорыт	киновечер
кинотеатр	кинотеатр
кинофестиваль	кинофестиваль
кинофильм	кинофильм
киняув	подмышки
киподтуй	мастерство
кипом	ручной
кирка	кирка
кисточка	кисточка
кисьмӧмлун	зрелость
китель	китель
китыр	горсть
китыр	пучок
кишечник	кишечник
кишка	кишка
клад	клад
кладбище	кладбище
кладовщик	кладовщик
классик	классик
клеитантор	заклейка
клей	клей
клейма	клеймо
клепайтӧмин	склепка
клестер	клейстер
клетка	клетка
климат	климат
клуб	клуб
клумба	клумба
кльӧк	сок
кляп	кляп
клятва	клятва
клёш	клёш
кнопка	кнопка
коа	шалаш
кобура	кобура
ковтыс	долина
ковтӧмтор	безделушка
коддьӧм	подобный
кодекс	кодекс
кодзувкоткар	муравейник
кожовник	кожевник
козъяин	ельник
козяль	прялка
койбедь	рогатина
койка	койка
кок	ножка
кокбӧр	каблук
кокйӧр	сила
коклябӧр	пятка
кокнилун	облегчение
кокнилун	легкомыслие
кокнилун	лёгкость
кокньӧд	облегчение
кокньӧд	помощь
кокньӧд	льгота
коко	яичко
коколюка	клюка
кокчӧр	голень
кокша	козлы
кокша	таган
кола	шалаш
коласт	промежуток
коласт	щель
коласт	зазор
колготки	колготки
колера	холера
колледж	колледж
коллектив	коллектив
коллекция	коллекция
колодка	колодка
колония	колония
колонна	колонна
колпак	колпак
колун	колун
колхозник	колхозник
коль	шишка
коль	серёжки
кольмӧдан	угарный
кольмӧдан	отравляющий
кольта	сноп
кольчуга	кольчуга
команда	команда
командировка	командировка
комбайн	комбайн
комбайнёр	комбайнер
комбат	комбат
комбикӧрым	комбикорм
комбинат	комбинат
комбинезон	комбинезон
комендант	комендант
коми	коми
комиссар	комиссар
комиссариат	комиссариат
комиссия	комиссия
комитет	комитет
коммерсант	коммерсант
коммунизм	коммунизм
коммунист	коммунист
компартия	компартия
комплекс	комплекс
комплект	комплект
композитор	композитор
компот	компот
компресс	компресс
комсомол	комсомол
комсомолеч	комсомолец
комсомолка	комсомолка
комсорг	комсорг
конвоир	конвоир
конгресс	конгресс
конкурент	конкурент
консерватория	консерватория
конспект	конспект
конституция	конституция
конструкция	конструкция
консульство	консульство
консультация	консультация
контракт	контракт
контрактация	контрактация
контратака	контратака
контролёр	контролёр
контузия	контузия
конференция	конференция
конфискация	конфискация
конфликт	конфликт
концерт	концерт
коньки	коньки
коньӧр	жалкий
конюк	конюх
конюшня	конюшня
кооператив	кооператив
кооперация	кооперация
копия	копия
копыр	поклон
коридор	коридор
кормушка	кормушка
король	король
корпа	корпус
корпус	корпус
корректор	корректор
корреспондент	корреспондент
корсянтор	искомый
корӧб	труха
корӧг	ком
корӧм	просьба
корӧм	требование
корӧм	спрос
корӧм	повестка
корӧмтор	заказ
корӧмтор	требование
корӧсь	веник
коскытш	пояс
коскытш	ремень
кослун	сухость
косметика	косметика
космос	космос
кост	зазор
косттор	щёлка
костюм	костюм
косысьпиян	утята
коттедж	коттедж
котыр	рой
котыртчытӧмлун	неорганизованность
кочегар	кочегар
кочӧг	колики
кошта	кошт
край	горбыль
край	край
крайтор	краюшка
краковяк	краковяк
краля	краля
кран	кран
краситчанін	красильня
краска	краска
крашенина	крашенина
кредит	кредит
крепыдлун	крепость
крепыдлун	прочность
крепӧсьт	крепость
креслӧ	кресло
крест	крест
крестьянка	крестьянка
критик	критик
критика	критика
круг	круг
кружка	кружка
кружок	кружок
круиз	круиз
крукӧдчан	ловушка
крупчатка	крупчатка
крут	крутой
крутін	крутизна
крысапи	крысёнок
крӧвать	кровать
ку	сочень
кувтӧмлун	бессмертие
кувшин	кувшин
куд	шкатулка
куд	клетка
куд	ящик
кудель	кудель
кужанлун	умение
кужтӧмлун	неумение
куз	хвощ
кузнеч	кузнец
кузнеча	кузница
кузов	кузов
кузьмӧслун	продолговатость
куйланін	лёжка
кулим	нерест
кулинар	кулинар
кулон	кулон
кульманін	нерестилище
культтӧвар	культтовары
кулёк	кулёк
кума	кума
кумыльга	водоворот
кунва	щёлок
кунӧр	буря
куплет	куплет
куран	грабли
куреньга	скелет
курич	косяк
курорт	курорт
курччӧмин	укус
курыдлун	горечь
курьер	курьер
курӧк	курок
куст	куст
кустарник	кустарник
кусынь	складка
кусынь	морщина
кусыняин	кривизна
кусӧдчысь	пожарник
кусӧк	кусок
кутчӧс	прицеп
кутян	щенок
кутӧд	бережливость
кутӧд	запрет
кучер	кучер
кучикгор	бубен
кушак	кушак
кушин	проталина
кушман	редька
кыа	заря
кыан	текстильный
кыв	маятник
кыв	слово
кывберт	скороговорка
кывбертас	скороговорка
кывбертлас	скороговорка
кывбур	стихотворение
кывйӧз	поговорка
кывйӧз	присловье
кывкуттӧмлун	безответственность
кывпас	голос
кывсянтор	достопримечательность
кывтэчас	фразеологизм
кывтэчас	словосочетание
кывчукӧр	словарь
кывшусьӧг	пословица
кызку	ватрушка
кызкуа	ватрушка
кызталун	толщина
кызін	утолщение
кыйӧмтор	добыча
кылӧдчанін	сплав
кынтӧм	озноб
кынӧмпӧт	пропитание
кып	гимн
кыпыдлун	жизнерадостность
кыпыдлун	воодушевление
кырас	русло
кырныш	ворон
кырнышпи	воронёнок
кырув	уклон
кырым	подпись
кырымпас	подпись
кытшов	оборот
кытшыль	изгиб
кыш	скорлупа
кыш	шелуха
кыш	обёртка
кыш	обложка
кӧбрӧг	погреб
кӧвдум	колобок
кӧврига	буханка
кӧвтым	бредень
кӧдзыдлун	холод
кӧдзыдін	холод
кӧзяева	хозяева
кӧзяин	хозяин
кӧзяйка	хозяйка
кӧзӧд	ледник
кӧинпи	волчонок
кӧлас	воротник
кӧлуй	принадлежности
кӧлыс	ворот
кӧлыс	связка
кӧлӧкӧльчик	колокольчик
кӧлӧсник	колосник
кӧм	обувь
кӧмкот	обувь
кӧмутина	хомутина
кӧнов	дуга
кӧнӧбой	проныра
кӧнӧвал	коновал
кӧпейка	копейка
кӧрпи	оленёнок
кӧртас	связка
кӧртвом	удила
кӧртдой	тысячелистник
кӧртым	аренда
кӧртымалан	арендный
кӧрчага	корчага
кӧрӧб	короб
кӧрӧбъя	коробок
кӧсйӧг	умысел
кӧсйӧмтор	обещанное
кӧстер	костёр
кӧсынка	косынка
кӧтас	примочка
кӧчан	капуста
кӧчпи	зайчонок
кӧш	ковш
кӧшель	кисет
кӧшель	кошелёк
лабаз	навес
лаборант	лаборант
лава	лава
лагер	лагерь
ладан	ладан
лажмыдлун	мелкость
лазарет	лазарет
лайда	низина
лайка	лайка
лайкан	оцеп
лайков	ложбина
лайкӧсін	долина
лайнер	лайнер
лак	лак
лакей	лакей
лампочка	лампочка
лапкор	подорожник
лапкор	лопух
лапӧд	клапан
лар	ларь
лареч	ларец
ларёк	ларёк
ласича	ласка
ласта	бечевник
лауреат	лауреат
лача	надежда
левпи	львёнок
легенда	легенда
легӧдӧм	тряска
лежнӧг	шиповник
лезвие	лезвие
лейка	лейка
лейтенант	лейтенант
лекало	лекало
лекар	лекарь
лекарство	лекарство
лексика	лексика
лекция	лекция
лем	клей
лем	слизь
лента	лента
леопард	леопард
лесоводство	лесоводство
леспромхоз	леспромхоз
лестука	рваный
лесьт	ласковый
леторос	поросль
летчысь	шерстобит
лешсьӧм	издёрганный
либерализм	либерализм
ликёр	ликёр
лилипут	лилипут
лимит	лимит
лимонад	лимонад
лингвист	лингвист
лингвистика	лингвистика
линейка	линейка
линза	линза
лиризм	лиризм
лирик	лирик
лирика	лирика
лисички	лисички
лист	лист
лист	противень
лист	лист
листовка	листовка
литератор	литератор
литература	литература
литр	литр
лихорадка	лихорадка
лицей	лицей
лицензия	лицензия
личалӧмин	слабина
личинка	личинка
личлун	послабление
личлэдзлытӧмлун	напряжённость
личыда	слабо
личыда	легко
личӧдӧм	облегчение
лишнӧйтор	лишнее
лоантор	будущее
лобзик	лобзик
лов	душа
ловгӧн	пушок
ловпуаин	ольховник
логика	логика
лодыр	лодырь
лозунг	лозунг
локатор	локатор
лолыштӧм	передышка
ломбард	ломбард
ломзьӧдчан	растопка
лоток	лоток
лоӧм	наступление
лоӧмтор	происшедшее
луд	пастбище
лудитчысь	лудильщик
лудысь	чесоточный
лудӧм	чесотка
луж	полуда
луккок	луковица
лунатик	лунатик
луннебӧг	дневник
луноход	луноход
лунысъя	подённый
лупа	лупа
лутш	сустав
лутш	запястье
лыбӧд	возвышенность
лыд	счёт
лыд	количество
лыд	число
лыддьӧг	перечень
лыддьӧдлӧм	причитание
лыддьӧмтор	прочитанное
лыдпас	цифра
лыжник	лыжник
лызнича	лыжня
лыйсьысь	трескучий
лыйсьӧм	перестрелка
лыйсьӧм	обстрел
лымань	снегурочка
лымдорчача	подснежник
лыпом	косточка
лысер	кости
лысьтысян	доильный
лытка	желудок
лытун	скиталец
лышкыдлун	щедрость
лыян	ружьё
льӧмкай	свиристель
лэбалан	самолёт
лэдзчысьтӧмлун	настойчивость
лэдзӧм	налитый
лэптан	выдерживающий
лэчталысь	точильщик
лэчыдлун	резкость
лэчыдлун	острота
любов	любовь
любӧйтор	всё
люк	люк
люстра	люстра
лютлун	тяготение
люцерна	люцерна
ляблун	изнеженность
ляблун	чувствительность
лявзӧм	тявканье
лявзӧм	вой
лявут	мелюзга
ляксьӧмин	пятно
лямка	лямка
ляпасея	неряха
ляпасея	сплетница
ляпкыдлун	плоскость
ляпкыдін	мель
ляпкыдін	брод
ляті	корь
лёкгоршӧн	истошно
лёклун	грубость
лёклун	скверность
лёклун	суровость
лёкпоз	злюка
лёктор	недостаток
лёльӧ	гусеница
лётчик	лётчик
лӧвгун	нытик
лӧвтӧм	хныканье
лӧглун	ненависть
лӧньлун	тишина
лӧньлун	спокойствие
лӧньӧдін	заводь
лӧсьыдтор	хорошее
лӧсьыдтӧм	неудобный
лӧсьыдтӧм	неаккуратный
лӧсьыдтӧм	неинтересный
лӧсьӧдӧм	подставленный
лӧсьӧдӧмтор	приобретение
лӧсьӧдӧмтор	измышление
лӧсявтӧмтор	неподходящее
лӧсялантор	подходящее
мавзолей	мавзолей
магазин	магазин
магнит	магнит
магометана	магометане
мазь	мазь
май	май
майка	майка
майӧг	кол
максимум	максимум
мамонт	мамонт
мампас	родинка
мампассьӧ	монпансье
мамча	медуница
манакиня	монахиня
мандат	мандат
мандолина	мандолина
манифест	манифест
манифестация	манифестация
марганцовка	марганцовка
маргарин	маргарин
маргаритка	маргаритка
мармелад	мармелад
март	март
мартышка	мартышка
массаж	массаж
масштаб	масштаб
масьт	масть
математик	математик
материал	материал
материализм	материализм
материалист	материалист
матысатор	близкое
матыслун	близость
мач	мяч
машинист	машинист
машинистка	машинистка
машинка	машинка
маяк	маяк
мегыр	дуга
мегӧ	барашек
меда	наёмный
медаль	медаль
медбӧръятор	последнее
медицина	медицина
мелодия	мелодия
мельник	мельник
меньшевизм	меньшевизм
мерка	мерка
месай	хозяин
месань	хозяйка
места	место
местатор	местечко
метеорит	метеорит
метод	метод
методика	методика
метр	метр
метро	метро
меть	наравне
механизатор	механизатор
механизм	механизм
механик	механик
механика	механика
мешӧк	мешок
мещанин	мещанин
микроб	микроб
микроскоп	микроскоп
микрофон	микрофон
милиционер	милиционер
миллиметр	миллиметр
миллионер	миллионер
милӧсьт	милость
мина	мина
минерал	минерал
минимум	минимум
министерство	министерство
министр	министр
миномёт	миномёт
минус	минус
минут	минута
миссионер	миссионер
миссия	миссия
мистика	мистика
мисьтӧмлун	грубость
митинг	митинг
миф	миф
мичлун	красота
мичмӧдантор	украшение
мичмӧдчантор	украшение
мичмӧдчантор	косметика
мичӧдчысь	красильщик
мишень	мишень
мобилизация	мобилизация
мода	мода
мода	манера
мода	сложение
мойд	сказка
мойпи	бобрёнок
молебен	молебен
молекула	молекула
молитва	молитва
мольберт	мольберт
момга	торф
монархист	монархист
монтаж	монтаж
монтажник	монтажник
монтёр	монтёр
мораль	мораль
мороз	мороз
морс	морс
мортлун	человечность
морттуй	характер
морттуй	разум
моряк	моряк
мотив	мотив
мотор	мотор
мотоцикл	мотоцикл
мошенник	мошенник
мувердас	удобрение
мувый	нефть
мудерпоз	хитрец
мудзлун	усталость
мудӧд	завалинка
мудӧд	насыпь
муза	муза
музей	музей
музыка	музыка
музыкант	музыкант
муйӧж	грунт
мукуа	землянка
мукӧдтор	иное
мунанног	способ
мундир	мундир
мунӧм	ход
мунӧм	сходство
мунӧм	расход
муош	крот
муртӧс	мерка
мусир	нефть
муслун	любовь
мусюр	водораздел
мутипи	бесёнок
мучудӧ	диковинка
мушка	мушка
мыв	сознание
мыджсянтор	опора
мыж	вина
мыжлун	виновность
мыжтӧмлун	невиновность
мыльк	холм
мыльктор	бугорок
мын	пошлина
мыр	пень
мырпом	морошка
мыт	понос
мыччӧд	данные
мыш	спина
мыш	горб
мышвыв	назад
мышкырлун	сутулость
мышноп	рюкзак
мӧвп	мечта
мӧвпсям	мировоззрение
мӧдлапӧв	заречье
мӧдтор	другое
мӧлӧтник	молотобоец
мӧссёркни	турнепс
набалдашник	набалдашник
набор	набор
наборщик	наборщик
навигация	навигация
нагайка	нагайка
награда	награда
нагрузка	нагрузка
надея	надежда
нажӧвитӧмтор	нажитое
наказ	наказ
наказанньӧ	наказание
накӧвальня	наковальня
налог	налог
налёт	налёт
напаръя	бурав
нар	нары
нарад	наряд
нартлун	безжалостность
наследник	наследник
наследство	наследство
насмука	насморк
настоятель	настоятель
национализм	национализм
националист	националист
национальносьт	национальность
нация	нация
начальник	начальник
начальство	начальство
наянлун	хитрость
небылича	небылица
небӧг	книга
небӧгтор	брошюра
невежа	невежа
невежество	невежество
невеста	невеста
невӧля	неволя
незбыль	неправда
неладнӧтор	неладное
немруй	мямля
неправда	неправда
неправлун	неправота
нерв	нерв
нетужилов	сорвиголова
неудача	неудача
неурожай	неурожай
нефтяник	нефтяник
нешуд	несчастье
ним	имя
ним	название
ним	звание
нималантор	достопримечательность
нимкодьлун	радость
нимкодьтор	приятное
нимпас	прозвище
новобранеч	новобранец
ног	послелог
номерок	номерок
ноп	котомка
норлун	грусть
норт	нарты
носки	носки
нотариус	нотариус
ноябр	ноябрь
нужда	нужда
нук	внук
нур	пропитание
нуртор	пропитание
нуръясянтор	еда
нуръясянін	закусочная
нывлун	девичество
нывсет	девичник
ныжлун	тупость
ныжлун	бессилие
ныр	нос
ныр	направление
ныркӧрша	переносица
ныртшуп	переносица
нырщик	вожак
ньӧбас	покупка
ньӧв	стрела
ньӧр	поросль
ньӧртор	прутик
нюдзлун	гибкость
нюйт	тина
нюйт	ил
нюйт	грязи
нюкыль	сгиб
нюкыр	корчи
нюусись	тюлень
няйтпоз	грязнуля
няк	ось
нярлун	чувствительность
нярлун	изнеженность
нёринь	наклон
нӧбас	ноша
нӧбовтас	пучок
нӧдкыв	загадка
нӧк	сметана
нӧш	колотушка
нӧш	валёк
обласьт	область
облигация	облигация
обоз	обоз
образ	образ
оброк	аренда
оброк	оброк
обряд	обряд
обычай	обычай
ов	фамилия
овмӧс	хозяйство
од	всходы
од	стебель
од	зелень
одеколон	одеколон
ожман	война
озырлун	богатство
оккупант	оккупант
оккупация	оккупация
околыш	околыш
округ	округ
окта	эффективный
оланподув	конституция
оланін	местопребывание
оласног	быт
оласног	обычай
олимпиада	олимпиада
олысь	бодрствующий
олӧм	быт
олӧм	бодрствование
омра	дягиль
омӧльтор	плохое
ониш	лень
опекун	опекун
оператор	оператор
операция	операция
опись	опись
ор	гной
оратор	оратор
организация	организация
организм	организм
орден	орден
ордним	фамилия
ордым	просека
ордӧмин	гнойник
оркестр	оркестр
орс	плеть
от	ширь
отбой	отбой
отечество	отечество
отличник	отличник
отпуск	отпуск
отрава	отрава
отряд	отряд
отчизна	отчизна
отчёт	отчёт
отыр	люди
отыр	богатырь
официантка	официантка
охра	охра
охрана	охрана
ошкуй	ушкуйник
ошпи	медвежонок
паб	ботва
падей	маска
падей	ряженый
падмӧг	задержка
падъян	короб
паз	паз
пай	часть
пай	лепта
пайщик	пайщик
пак	пах
пакля	пакля
пакт	пакт
пактас	испарение
пакӧсьт	проказа
палак	глыба
палак	пласт
палач	палач
палуба	палуба
палъя	комлистый
пальник	подсека
пальӧдчанін	вытрезвитель
паметь	память
памятник	памятник
пан	пан
панапида	панихида
панас	суть
панас	вступление
паника	паника
панов	отруби
панорама	панорама
паныдасьлытӧмтор	фантастика
паныдасьлытӧмтор	уникум
паньтӧм	тёзка
папка	папка
папуша	бумажник
параграф	параграф
парикмахер	парикмахер
парикмахерскӧй	парикмахерская
парк	парк
парламент	парламент
пароль	пароль
парсасьӧмин	царапина
партбилет	партбилет
партбюро	партбюро
партизан	партизан
партизанка	партизанка
партком	партком
парторг	парторг
пасека	пасека
пасйӧд	замечание
пасйӧд	примечание
паспорт	паспорт
пассажир	пассажир
паста	паста
паськыдін	простор
патент	патент
патерщик	квартирант
патриарх	патриарх
патриотизм	патриотизм
патронташ	патронташ
пашкырлун	пышность
паяльник	паяльник
паёк	паёк
пеган	подпалина
педагог	педагог
педаль	педаль
педучилище	педучилище
пежгаг	ящерица
пежлун	гнусность
пезин	силок
пекнича	пятница
пель	слух
пельмень	пельмени
пельтӧмлун	глухота
пельшӧр	фельдшер
пемдандор	сумерки
пенсия	пенсия
перебой	перебой
переворот	переворот
перевязка	перевязка
передача	передача
переплёт	переплёт
перепроизводство	перепроизводство
перерыв	перерыв
перестройка	перестройка
переч	перец
перилӧ	перила
перспектива	перспектива
перӧ	перо
песласянін	прачечная
петантор	выделение
петас	всходы
петель	фитиль
петкӧдлантор	репертуар
петкӧдлас	показатель
петшӧраин	крапивник
печат	пятно
печат	печать
печенньӧ	печенье
печик	щелчок
печкан	пряслице
пещера	пещера
пианино	пианино
пилипызь	опилки
пилот	пилот
пипетка	пипетка
пипуаин	осинник
пипӧв	дети
пират	пират
писатель	писатель
пистолет	пистолет
письмӧ	письмо
письтӧмин	прорыв
питомник	питомник
питшӧг	пазуха
пиявка	пиявка
плавки	плавки
плавкӧслун	плоскость
плакат	плакат
план	план
планета	планета
планӧвик	плановик
плацдарм	плацдарм
плацкарт	плацкарт
плащ	плащ
плен	плен
пленум	пленум
плод	плод
пломба	пломба
площадка	площадка
плуг	плуг
плут	плут
плёнка	плёнка
поверье	поверье
повесьт	повесть
поводдя	погода
погода	буря
пограничник	пограничник
подбӧр	каблук
подвиг	подвиг
поддін	комель
поддін	основание
подписка	подписка
подполковник	подполковник
подполье	подполье
подпольщик	подпольщик
подстанция	подстанция
подъезд	подъезд
поезд	поезд
поз	гнездо
поз	коробочка
позтыр	выводок
позьтӧмлун	невозможность
позянлун	возможность
покрывалӧ	покрывало
поле	поле
поликлиника	поликлиника
политэкономия	политэкономия
полномочие	полномочие
полупроводник	полупроводник
польк	пузырь
помка	отговорка
понгум	василистник
понедельник	понедельник
понзӧр	овсюг
понпиян	щенята
попаддя	попадья
пором	затор
порськок	лопух
порсьпи	поросёнок
порт	порт
портрет	портрет
портсигар	портсигар
портфель	портфель
порция	порция
порча	порок
поснитор	подробности
посол	посол
посольство	посольство
пост	пост
поступок	поступок
потас	русло
потас	просека
потас	пробор
потребитель	потребитель
потш	жердь
потшӧс	заграждение
поход	поход
походка	походка
почва	почва
почерк	почерк
почёт	почёт
поэзия	поэзия
поэма	поэма
поэт	поэт
праватӧмлун	бесправие
правительство	правительство
правлун	правота
прамӧйлун	порядочность
прать	клок
представитель	представитель
президиум	президиум
преимущество	преимущество
премьера	премьера
преник	пряник
прибор	прибор
прививка	прививка
привычка	привычка
приказчик	приказчик
приклад	приклад
припас	припасы
присяга	присяга
присядки	вприсядку
приход	приход
прицеп	прицеп
приёмщица	приёмщица
пробой	пробой
провод	провод
проводник	проводник
провокация	провокация
программа	программа
прогресс	прогресс
прогул	прогул
прогулка	прогулка
продукция	продукция
проект	проект
проза	проза
производство	производство
прокурор	прокурор
пролетариат	пролетариат
пропаганда	пропаганда
прописка	прописка
проповедь	проповедь
пропорция	пропорция
прорыв	прорыв
пространство	пространство
протез	протез
протест	протест
профессия	профессия
профессор	профессор
профилактика	профилактика
профтехучилище	профтехучилище
процент	процент
прӧдук	продушина
прӧсек	просека
прӧстлун	щедрость
прӧстлун	расточительность
прӧстуда	простуда
прӧстӧйлун	простота
прӧтивник	противник
псевдоним	псевдоним
психология	психология
публицистика	публицистика
пувъяин	брусничник
пудра	пудра
пудъясянкыв	считалка
пуж	иней
пукаланін	посиделки
пуклӧс	сиденье
пуклӧс	седло
пуклӧс	облучок
пуксянін	сиденье
пуктӧмтор	вложение
пуктӧмтор	посадки
пукыль	палочка
пукыль	катыш
пукыль	поплавок
пульс	пульс
пур	плот
пурӧмин	укус
пустыня	пустыня
пустӧйлун	озорство
пустӧйлун	пустота
пусянін	кухня
путешественник	путешественник
путьтӧмлун	верхоглядство
путёвка	путёвка
пушкырлун	пышность
пушнина	пушнина
пыдӧс	конец
пызан	стол
пыксянтор	опора
пылесос	пылесос
пыранін	доступ
пыридз	пешня
пыртсим	усы
пыс	ушко
пыстапи	синичка
пытка	пытка
пытшкӧс	полость
пытшкӧс	начинка
пышкайпи	воробьёнок
пьеса	пьеса
пьянник	пьяница
пӧварня	предбанник
пӧвестка	повестка
пӧвст	прядь
пӧвст	ряд
пӧвст	слой
пӧгреб	погреб
пӧдан	заслонка
пӧденщина	подёнщина
пӧдлӧс	клапан
пӧдпруга	подпруга
пӧдруга	любовница
пӧдушка	подушка
пӧдӧнча	подойник
пӧжалӧмтор	выпечка
пӧжас	выпечка
пӧжасянін	пекарня
пӧим	зола
пӧим	пепел
пӧкмелля	похмелье
пӧлагайтчантор	должное
пӧлать	полати
пӧлучка	получка
пӧрадок	порядок
пӧрйӧг	приманка
пӧрука	порука
пӧрысьдыр	старость
пӧслӧвича	пословица
пӧстать	участок
пӧсьйывсьыс	вспотев
пӧтка	дичь
пӧтлун	сытость
пӧч	старуха
пӧщада	пощада
равноправие	равноправие
радейтӧмлун	любовь
радикулит	радикулит
радио	радио
радиокомитет	радиокомитет
радиопель	наушники
радиопередача	радиопередача
радиоприёмник	радиоприёмник
разбойник	разбойник
разведка	разведка
разведчик	разведчик
размер	размер
разруха	разруха
разъезд	разъезд
райисполком	райисполком
райком	райком
районо	районо
ракаяй	мездра
ракета	ракета
ракпань	раковина
ракпи	рачок
рапорт	рапорт
расписка	расписка
расплата	расплата
расправа	расправа
растрата	растрата
расценка	расценка
расчёска	расчёска
рацион	рацион
рационализатор	рационализатор
рация	рация
рач	сковородка
рач	котелок
рачвыв	колобок
рашпиль	рашпиль
ревизия	ревизия
ревматизм	ревматизм
революция	революция
редактор	редактор
редакция	редакция
редколлегия	редколлегия
режим	режим
режиссёр	режиссёр
резерв	резерв
резолюция	резолюция
результат	результат
резьӧб	брызги
рейд	рейд
рейтуз	рейтузы
рекомендация	рекомендация
реконструкция	реконструкция
рекорд	рекорд
религия	религия
рель	виселица
ремень	ремень
ремонт	ремонт
репей	репейник
репортаж	репортаж
репрессия	репрессия
репутация	репутация
республика	республика
рессора	рессора
ретивлун	ретивость
реферат	реферат
референдум	референдум
реформа	реформа
рецензия	рецензия
решетка	решётка
риск	риск
ритм	ритм
рифма	рифма
роботник	работник
роботнича	работница
рогатка	рогатка
рожа	лицо
рожок	рожок
розанка	неряха
розга	розга
розь	гнездо
розь	свищ
розь	скважина
розьӧдӧмин	прорез
розьӧдӧмин	прорыв
розьӧдӧмин	пробой
розялӧмин	пробоина
рок	каша
рота	рота
роч	русский
рояль	рояль
рубильник	рубильник
рубль	рубль
рубрика	рубрика
ружье	ружьё
руководитель	руководитель
рукопись	рукопись
рулон	рулон
ручпи	лисёнок
рушлун	дряблость
ры	полынья
рысьва	сыворотка
рӧдвыв	племенной
рӧдманлун	плодовитость
рӧдманін	питомник
рӧдмӧм	рождаемость
рӧзваль	розвальни
рӧмпӧштан	зеркало
рӧмыдлун	сумрак
рӧсада	рассада
рӧсов	рассол
рӧшкыдлун	рассыпчатость
рӧшкыдлун	хрупкость
рӧщӧт	расчёт
сабри	стог
сава	чернила
садитӧмтор	посадки
садовод	садовод
сайин	укрытие
сайӧдантор	завеса
сакарнича	сахарница
салон	салон
салфетка	салфетка
салют	салют
самодержавие	самодержавие
самокритика	самокритика
санаторий	санаторий
санитарка	санитарка
саранча	саранча
саревич	царевич
саревна	царевна
сартас	лучина
сартаспом	лучинка
сатира	сатира
сваття	сватья
свежӧйлун	свежесть
свидетельство	свидетельство
свод	свод
сеанс	сеанс
седлӧ	седло
сезон	сезон
секретар	секретарь
секция	секция
семинар	семинар
семинария	семинария
сепаратор	сепаратор
сепыс	мешок
серам	смех
серия	серия
сермӧд	узда
серпас	образ
серпас	иллюстрация
серпасалысь	художник
серпасасьысь	художник
серпастор	зарисовка
серӧда	среда
сечка	сечка
сеялка	сеялка
сибаланлун	подход
сибус	пороша
сибӧдчанін	подход
сигарет	сигарета
сигнал	сигнал
сигӧртас	купол
сидодь	волокуша
сизима	семёрка
сийӧс	хомут
сиктсӧвет	сельсовет
сикӧтш	бусы
сикӧтш	ожерелье
силач	силач
симметрия	симметрия
син	зрение
син	глазок
синтӧмлун	близорукость
сироп	сироп
сирӧдлун	смолистость
сирӧта	сирота
скарлатина	скарлатина
скважина	скважина
сквер	сквер
скворечник	скворечник
скипидар	скипидар
складка	складка
склероз	склероз
скобка	скобка
скодни	сходни
скрепка	скрепка
скульптура	скульптура
скӧба	скоба
скӧвер	мат
скӧвӧрда	сковорода
скӧрпоз	злюка
слега	слега
следователь	следователь
следствие	следствие
слесарня	слесарная
слуда	гряда
слук	слух
слӧнпи	слонёнок
смек	смех
смета	смета
смысл	смысл
снайпер	снайпер
собранньӧ	собрание
собственносьт	собственность
сов	засол
сод	лестница
сода	сода
содз	пригоршня
сойпу	шатун
соловей	соловей
сонет	сонет
сорас	месиво
сорас	примесь
сорма	роща
сортируйтчанін	сортировочная
сотрудник	сотрудник
сотрудничество	сотрудничество
сотчӧмин	ожог
соус	соус
социализм	социализм
социолог	социолог
союзник	союзник
спартакиада	спартакиада
спектакль	спектакль
специалист	специалист
специальносьт	специальность
спецовка	спецовка
спина	спина
список	список
сплав	сплав
сплош	сплошь
сподоба	специи
спонсор	спонсор
спорина	сытность
спортсмен	спортсмен
спояйтӧмтор	впайка
справка	справка
справочник	справочник
срам	пакость
средство	средство
срок	срок
сруб	сруб
ссуда	ссуда
ставтор	всё
стадион	стадион
стаж	стаж
стажёр	стажёр
стамеска	стамеска
стандарт	стандарт
становье	заимка
станция	станция
старик	старик
старука	старуха
старӧвер	старовер
старӧста	староста
статуя	статуя
стачка	стачка
стега	омёт
стен	стена
стенгазет	стенгазета
стенд	стенд
стипендия	стипендия
стойла	стойло
столб	столб
столбик	столбец
столяр	столяр
стопка	стопка
страда	страда
стража	стража
страна	страна
стрела	стрела
стрелок	стрелок
стремена	стремя
струна	струна
стрӧительство	строительство
стрӧитӧмтор	постройка
стрӧпилӧ	стропило
стыд	стыд
стӧкан	стакан
стӧрӧжка	сторожка
стӧчлун	точность
стӧчлун	пунктуальность
субӧтник	субботник
сувтов	остановка
сувтӧдаланног	расстановка
сугӧн	лук
судзсьытӧмлун	бедность
судзсянлун	достаток
судитанног	правосудие
судно	судно
судьба	судьба
суклун	жирность
сулаланін	стойбище
сулик	насквозь
сулик	обильно
сулӧк	полотенце
суматока	суматоха
сунис	пряжа
супонь	супонь
сурым	смерть
сусан	грязнуля
суседка	соседка
сутки	сутки
сутшик	икота
схема	схема
сцена	сцена
счёт	счёт
счётчик	счёччик
съезд	съезд
сыв	талый
сыв	обхват
сывборд	объятие
сывборд	крылья
сывтыр	объятие
сывтыр	охапка
сыланлун	растворимость
сыланлун	плавкость
сылӧмин	проталина
сынан	скребница
сыч	сыч
сьылан	вокальный
сьылысь	певчий
сьӧдкай	скворец
сьӧдӧб	чернота
сьӧдӧдӧмин	затемнение
сьӧкыдтор	трудность
сьӧлӧм	дух
сьӧлӧмлич	отрада
сэрӧг	захолустье
сэтшӧмтор	такое
сюжет	сюжет
сюзьпи	совёнок
сюн	ил
сюсьлун	находчивость
сюсьлун	зоркость
сюсьлун	мастерство
сям	склад
сямтӧмлун	бестактность
сямтӧмлун	бесхарактерность
сямтӧмлун	бестолковость
сяр	граната
сярган	трещотка
сярган	погремушка
сёрнитчан	согласительный
сёрнитчӧдысь	посредник
сёртас	русло
сёртас	долина
сі	усики
сі	прожилка
сійӧтор	то
сісьмӧмтор	гнильё
сӧвестнӧ	совестно
сӧвик	совик
сӧвмӧмлун	зрелость
сӧглас	согласованность
сӧстӧмлун	невинность
сӧстӧмлун	свежесть
таблетка	таблетка
табло	табло
тагӧс	порог
таз	таз
тайна	тайна
тайӧтор	это
такси	такси
тактика	тактика
талон	талон
тальыштлӧмин	след
танк	танк
танкист	танкист
тара	тара
тарантас	тарантас
таркнитӧм	встряска
татшӧмтор	такое
татшӧмтор	следующее
творчество	творчество
тезис	тезис
текст	текст
телевизор	телевизор
телеграмма	телеграмма
телеграфист	телеграфист
телепередача	телепередача
телескоп	телескоп
телестудия	телестудия
телетайп	телетайп
телефонист	телефонист
телефонистка	телефонистка
телефонограмма	телефонограмма
телецентр	телецентр
теля	оленёнок
телӧ	тело
телӧгрейка	телогрейка
тема	тема
темперамент	темперамент
температура	температура
теннис	теннис
теорема	теорема
теоретик	теоретик
тепловоз	тепловоз
теплоход	теплоход
терапевт	терапевт
термин	термин
термометр	термометр
термос	термос
терпливлун	терпеливость
террорист	террорист
тертука	тёрка
тесьт	тесть
техник	техник
техникум	техникум
технолог	технолог
технорук	технорук
тигрпи	тигрёнок
типография	типография
тир	тир
тираж	тираж
тирган	сверчок
тоин	пест
той	вошь
толь	толь
томлун	молодость
тонна	тонна
топаз	топаз
топограф	топограф
топыдлун	плотность
торт	торт
торшер	торшер
торъяланін	развилина
тост	тост
тотара	татары
тотарин	татарин
тоткун	брюзга
тош	борода
традиция	традиция
тракт	тракт
трактир	трактир
тракторист	тракторист
транзистор	транзистор
транзит	транзит
транспорт	транспорт
транспортёр	транспортёр
трансформатор	трансформатор
траншея	траншея
трасича	сорванец
траулер	траулер
тревога	тревога
треко	трико
трибуна	трибуна
тригонометрия	тригонометрия
триньӧ	колокольчик
тройка	тройка
трубича	катушка
трубича	ступица
трубка	рулон
труд	труд
труппа	труппа
трус	трус
трусик	трусики
трюм	трюм
трюмо	трюмо
трӧпилӧ	стропило
туалет	туалет
туг	бахрома
туган	крона
тужурка	тужурка
туйдчӧмин	надлом
туйныр	направление
туйпас	ориентировка
туйтӧмлун	негодность
тулуп	тулуп
тумба	тумба
тундра	тундра
туннель	туннель
тупича	колун
тупйӧд	пробка
тупкӧд	затемнение
тупыль	клубок
тупыль	завязь
турбаза	турбаза
туримоль	пион
турипи	журавлёнок
турник	турник
турнир	турнир
турыш	кошелёк
тутгум	купырь
туша	туша
туша	рост
туясьысь	следопыт
туясьысь	следователь
тшак	гриб
тшакаин	грибница
тшалӧк	пряжка
тшан	чан
тшаплун	жеманность
тшебер	былинка
тшупас	сруб
тшыкӧд	порча
тшын	дым
тшытшыбылка	вертихвостка
тшӧг	сочный
тшӧглун	тучность
тшӧглун	сочность
тшӧка	подбородок
тшӧктӧм	просьба
тшӧктӧм	приглашение
тшӧктӧм	предписание
тшӧктӧм	приказ
тшӧкыдлун	густота
тшӧт	чёт
тшӧтшамас	приплюснутый
тшӧтшамӧс	приплюснутый
тшӧть	щетина
тшӧті	счёты
тывкӧрт	огниво
тыдӧс	вид
тыл	тыл
тылым	клок
тыралантор	начинка
тырманлун	достаток
тьӧт	мачеха
тьӧща	тёща
тэчас	омёт
тэчасног	устройство
тюк	тюк
тюни	валенки
тюрзан	свисток
тюрик	катушка
тюрик	каток
тівк	толчок
тільгун	колокольчик
тірӧб	дрожь
тӧб	моток
тӧвдӧра	парус
тӧвъянін	зимовье
тӧдлытӧмтор	неожиданность
тӧдмӧс	признак
тӧдтӧмлун	загадочность
тӧдтӧмлун	неизвестность
тӧдтӧмлун	неведение
тӧдӧмлун	знание
тӧлктӧмтор	безумство
тӧлысся	месячный
тӧлысся	менструация
тӧлысь	месяц
тӧрг	торги
тӧрича	торица
тӧрӧг	торос
тӧрӧкан	таракан
тӧщӧин	пустота
уваль	увалень
увпыш	посконь
увт	подошва
угоддьӧ	угодье
удаллун	проворство
удача	удача
удача	умение
уджалӧм	занятие
уджачлун	трудолюбие
уджйӧзтор	должок
уджмог	обязанность
уджтор	дельце
уджтӧмалысь	безработный
уезд	уезд
ужпи	жеребчик
ужпинь	спорынья
ужын	ужин
узор	узор
узьмӧдчанін	ночлег
узьӧм	ночлег
узьӧм	спячка
уйт	пойма
уйтырлун	подлость
указ	указ
укват	ухват
укшальлун	слабость
улей	улей
улим	слизь
улислун	сочность
улислун	тучность
улича	улица
ульлун	влажность
ультиматум	ультиматум
унапӧлӧслун	многообразие
унатор	многое
универмаг	универмаг
унпур	соня
управа	управа
урадник	урядник
урма	шайка
урна	урна
уровень	уровень
урожай	урожай
урок	урок
урон	урон
урпи	бельчонок
урпинь	клык
уртшак	сыроежка
усадьба	усадьба
уселон	заключённый
уселон	осуждённый
уселон	лагерник
условие	условие
услуга	услуга
устор	усики
уступка	уступка
усюр	надзор
уткапи	утёнок
утюг	утюг
утіча	подсанки
училище	училище
учёт	учёт
ушат	ушат
ушкуй	ушкуй
уянін	брод
фабрика	фабрика
фабрикант	фабрикант
факультет	факультет
фельетон	фельетон
ферма	ферма
фигура	фигура
физик	физик
физкультурник	физкультурник
филолог	филолог
философ	философ
фильм	фильм
фильтр	фильтр
фокус	фокус
фонтан	фонтан
фотография	фотография
фрак	фрак
фрукты	фрукты
фуражка	фуражка
футляр	футляр
фуфайка	фуфайка
халат	халат
харей	хорей
химик	химик
хирург	хирург
хлопок	хлопок
ходатайство	ходатайство
хозрасчёт	хозрасчёт
хромка	хромка
хроника	хроника
художество	художество
хутор	хутор
центнер	центнер
цивилизация	цивилизация
цинга	цинга
цинк	цинк
циркуль	циркуль
цитата	цитата
циферблат	циферблат
чабыр	кулак
чавканпи	галчонок
чаг	щепка
чага	чага
чаз	жмыхи
чайник	чайник
чалма	чалма
чальпас	копыто
чап	кичига
чапура	черпалка
чард	молния
чардак	чердак
чарла	серп
чарӧм	наст
часовня	часовня
чассьӧ	счастье
чахотка	чахотка
чача	безделушка
чашкалӧмин	расщеп
чекист	чекист
чемодан	чемодан
чепӧльтӧс	клещи
черань	паук
чернила	чернила
чертёж	чертёж
чесьт	честь
четверг	четверг
четверть	четверть
чечуль	ломоть
чибӧ	жеребёнок
чиганпи	цыганёнок
чигарка	цигарка
чиглун	аккуратность
чиглун	требовательность
чиглун	изысканность
чикыль	завязь
чикысь	коса
чикыш	ласточка
чин	чин
чипанпи	цыплёнок
чипсан	свистулька
чирзас	гримаса
чирук	кукиш
чита	изморозь
чишкасьӧмтор	паленина
член	член
чокан	чекан
чокан	клеймо
чокыр	мерин
чолка	чёлка
чом	шалаш
чом	конура
чувки	чулки
чужанвуж	род
чужанвуж	предки
чужанлун	всхожесть
чужанін	месторождение
чужтас	ребёнок
чуйдӧс	объявление
чуклялун	косослойность
чуктӧс	прибыль
чукыльтанін	поворот
чукыльӧсь	волнистый
чукыр	сгиб
чукӧр	выводок
чукӧртанін	вместилище
чукӧртанін	свалка
чукӧртчӧм	съезд
чулкиюр	носки
чум	чум
чума	чума
чуньлыс	напёрсток
чусмӧмлун	тусклость
чутік	головастик
чышъян	платок
чӧвин	затишье
чӧвтӧд	намётка
чӧдлач	голубика
чӧжйӧв	молозиво
чӧлнӧк	челнок
чӧрс	веретено
чӧрс	ось
чӧрт	чёрт
чӧртпи	чертёнок
чӧскыдлун	вкус
чӧскӧдантор	приправа
чӧсмасянтор	лакомство
шаг	шаг
шадз	хворостина
шаланда	шаланда
шалаш	шалаш
шаньног	достоинство
шапка	шапка
шатин	хворостина
шатин	удилище
шахтёр	шахтёр
шашка	шашка
швейцар	швейцар
шедас	добыча
шедӧдӧмтор	достижение
шеп	колос
шер	град
шеф	шеф
шефство	шефство
шкап	шкаф
школа	школа
шлагбаум	шлагбаум
шлапӧ	лепёшка
шлачкан	хлопушка
шлея	шлея
шливки	сливки
шляпа	шляпа
шлём	шлем
шовинизм	шовинизм
шовинист	шовинист
шогмытӧмлун	негодность
шогсьытӧмлун	беспечность
шой	падаль
шойданник	оборванец
шойччӧг	отпуск
шомкор	щавель
шоммӧд	опара
шомпур	шомпол
шомшеп	головня
шондіюр	подсолнечник
шонтӧд	обогреватель
шпагат	шпагат
шпулька	шпулька
шрифт	шрифт
штабель	штабель
штамп	штамп
штукатурка	штукатурка
штурм	штурм
шуд	счастье
шудлун	счастье
шудтӧмлун	несчастье
шуйгин	левша
шум	шум
шурыдлун	проворство
шутка	шутка
шутёв	свист
шыаланног	звучание
шыдӧспом	крупинка
шыдӧстор	крупица
шыж	мокрота
шын	шина
шынель	шинель
шыпас	буква
шыпаскуд	букварь
шыпича	шиповник
шыпурт	меч
шыпурт	штык
шырпи	мышонок
шырсьысь	парикмахер
шырсянін	парикмахерская
шыш	вор
шыӧдчӧм	заявление
шыӧдчӧм	декларация
шӧрин	центр
щель	щель
щӧті	счёты
ыбкай	жаворонок
ыв	каркас
ыджыдалӧм	преобладание
ыджыдалӧм	предводительство
ыжнёнь	жимолость
ылна	даль
ынь	пламя
ыньби	пламя
ыръянлун	упрямство
ышлов	вздох
ышлов	дыхание
ыштӧд	соблазн
эбӧстӧмлун	бессилие
эволюция	эволюция
эгоизм	эгоизм
эгоист	эгоист
эжтас	горизонт
экземпляр	экземпляр
экипаж	экипаж
экономика	экономика
экран	экран
экскурсия	экскурсия
экспедиция	экспедиция
эксперимент	эксперимент
экспертиза	экспертиза
экспозиция	экспозиция
экспонат	экспонат
экспорт	экспорт
элеватор	элеватор
электрик	электрик
электрификация	электрификация
электричество	электричество
электромонтаж	электромонтаж
электромонтёр	электромонтёр
электропоезд	электропоезд
электропровод	электропровод
электросварщик	электросварщик
электростанция	электростанция
электроэнергия	электроэнергия
элемент	элемент
эмиграция	эмиграция
эмлун	наличие
эмтор	быль
энергия	энергия
энтузиазм	энтузиазм
энузиаст	энтузиаст
энька	свекровь
эньлов	женщина
эпиграф	эпиграф
эпизод	эпизод
эпитет	эпитет
эпоха	эпоха
эскадра	эскадра
эскадрилья	эскадрилья
эскадрон	эскадрон
эсканлун	доверительность
эсканпас	доверенность
эскӧданпас	удостоверение
эстафета	эстафета
эстетика	эстетика
этажерка	этажерка
этшаник	немного
этшатор	немногое
этюд	этюд
эшелон	эшелон
эштытӧмлун	занятость
юанін	водопой
юбиляр	юбиляр
ювелир	ювелир
югӧр	просвет
югӧр	зарево
юда	иуда
юкас	паёк
юква	уха
юкмӧс	прорубь
юков	пробор
юков	проход
юкталанін	водопой
юкӧдув	подраздел
юкӧдув	подотдел
юмовлун	сладость
юмор	юмор
юн	вьюн
юн	минога
юннат	юннат
юр	головка
юр	копна
юр	шляпка
юр	горлышко
юрбитанін	молельня
юрводз	козырёк
юрганног	звучание
юргез	канат
юрдзиб	макушка
юрисконсульт	юрисконсульт
юрист	юрист
юрйыв	подворотничок
юрйыв	купол
юрйыв	изголовье
юркар	столица
юркытш	венок
юркыш	капюшон
юрним	рубрика
юрпесан	головоломка
юрта	юрта
юртас	венец
юртыр	кокошник
юстиция	юстиция
юсь	лебедь
ютш	топляк
ютыр	партия
юшка	вьюшка
юӧрпас	повестка
юӧртӧм	объявление
ябыр	скворец
ягсер	волнушка
яд	яд
ядрӧ	ядро
якӧр	якорь
яндзим	смущение
ярманга	ярмарка
яровизация	яровизация
ясли	ясли
ячейка	ячейка
ёг	соринка
ёгтор	соринка
ёді	лещ
ёжпи	ежонок
ёкмыль	клуб
ёрд	суд
ёрд	клятва
ёрдысь	судья
ёркыв	проклятие
ёрт	товарищ
ёрт	напарник
ёртлун	дружба
ёсьлун	резкость
ёсьлун	бойкость
ӧбедня	обедня
ӧбида	обида
ӧдзӧстор	дверца
ӧднӧколка	одноколка
ӧдъялун	калорийность
ӧдъялун	жара
ӧдӧб	расторопность
ӧдӧб	порыв
ӧжын	долото
ӧзим	озимь
ӧзталысь	зажигающий
ӧзталысь	поджигающий
ӧключина	уключина
ӧкмыса	девятка
ӧмидз	малинник
ӧрешки	орехи
ӧслӧп	увалень
ӧслӧп	верзила
ӧтава	отава
ӧтвесьталун	равновесие
ӧтвет	ответ
ӧтвизь	шеренга
ӧтитор	одно
ӧтказ	отказ
ӧткалун	одиночество
ӧткодьлун	равенство
ӧткодьтор	общее
ӧтлаасянін	слияние
ӧтлаасянін	смычка
ӧтрӧстель	поросль
ӧтсяма	сходный
ӧтувлун	объединение
ӧтувтчӧм	союз
ӧтувъя	объединённый
ӧтувъялун	коллективность
ӧтчаяннӧйлун	отчаянность
ӧтъяин	площадка
ӧч	ягода
ӧшиньтор	оконце
ӧшым	декабрь
ӧшӧдчӧмин	навес
вит	пять
первой	первичный
первой	впервые
не	нет
нӧ	разве
бокладорсянь	сбоку
вевдорын	над
выйын	при
вӧсна	послелог
дыра	послелог
йылысь	послелог
йылысь	на
кежысь	забредший
кежысь	уклоняющийся
мысти	послелог
мысти	после
орд	род
помын	у
понда	послелог
понда	за
пыр	послелог
пытш	тля
ради	послелог
ради	за
серти	послелог
серти	для
сьӧрысь	послелог
ӧтсор	послелог
некод	некого
некутшӧма	никак
некысь	нигде
некысь	негде
некысянь	ниоткуда
некысянь	неоткуда
некыт	нигде
некыт	негде
некытчӧ	никуда
некытчӧ	некуда
некытчӧдз	никуда
эсымында	столько
абутӧмасьны	прибедняться
абутӧммӧдны	устранить
абутӧммӧдны	ликвидировать
авансируйтны	авансировать
авкнитны	крикнуть
агсавны	боронить
агсавны	бороновать
агсавны	пробороновать
агсавны	взборонить
агсавны	взбороновать
адгоршавны	заграбастать
аддзывлыны	наблюдать
аддзывны	насмотреться
аддзыны	найти
аддзӧдлыны	повидать
адресуйтны	адресовать
акайтны	ахать
акйӧдлыны	ухать
аклявны	мять
акнитны	ухнуть
активизируйтны	активизировать
аннулируйтны	аннулировать
апавны	вдыхать
аплодируйтны	аплодировать
арендуйтны	арендовать
арестуйтны	арестовать
арзыны	рычать
артассьыны	считаться
артасьны	считать
артмыны	удаться
артмыны	вырваться
артмыны	формироваться
артмӧдны	составить
артмӧдчыны	образоваться
асныравны	капризничать
аснырасьны	упрямиться
атакуйтны	атаковать
атшавны	запыхаться
бавгӧдчыны	растянуться
байкӧдны	качать
баллотируйтны	баллотировать
баллотируйтчыны	баллотироваться
балуйтӧдны	баловать
банйӧдчыны	нарумяниться
барствуйтны	барствовать
баруньӧавны	бездельничать
баръёвтны	косолапить
баръёвтны	заплетаться
барышничайтны	барышничать
батрачитны	батрачить
бездействуйтны	бездействовать
безобразничайтны	безобразничать
бергавны	толпиться
бергавны	витать
бергӧдлыштны	поворошить
бергӧдны	вывернуть
бергӧдны	развернуть
бергӧдны	отговорить
бергӧдны	взметать
бергӧдчавны	отворачиваться
бергӧдчыны	развернуться
бертны	клонить
бертовтны	свернуть
бертовтны	перекрутить
бертовтчыны	перевернуться
бертовтчыны	вывихнуться
бертыштны	выворотить
бертыштны	свергнуть
бертыштчыны	вывернуться
беситчыны	беситься
беспокоитчыны	волноваться
бетонавны	бетонировать
блёнӧдчыны	бренчать
бовзьӧдны	поплестись
божитчыны	божиться
боквывтчыны	стоптаться
боксуйтчыны	боксировать
болльӧдны	пузырить
боллясьны	пузыриться
болскакывны	хлюпать
болскысьны	бултыхаться
больӧдны	тараторить
больӧдчыны	лепетать
больӧдчыны	щебетать
бомбардируйтны	бомбардировать
бомбитны	бомбить
бонзьыны	измучиться
боргыны	журчать
боргыны	бормотать
бордйысьны	драться
борӧдчыны	бормотать
босьтавны	брать
босьтавны	запевать
босьтлыны	получать
босьтлыны	снимать
босьтлыны	запевать
босьтлыны	заливать
босьтны	набрать
босьтчыны	подняться
босьтчыны	развиться
босьтчыны	разойтись
босьтчыны	разгореться
босьтчӧдны	выделяться
ботсьыны	разболтаться
братайтчыны	брататься
бреньгыны	бренчать
бринькйӧдлыны	брякать
бринькнитны	брякнуть
бринькнитны	прыгнуть
бриньӧбтыны	брякнуть
бронируйтны	бронировать
бронӧбтыны	буркнуть
бротьйӧдлыны	пинать
брунгыны	бренчать
брунгыны	звенеть
брунӧдчыны	бренчать
брунӧдчыны	гудеть
брызжитны	брызгать
брызьйӧдлыны	разбрасывать
брызьйӧдлыны	выплёскивать
брызьнитны	брызнуть
брӧдитны	бродить
бувгыны	бушевать
бугритны	окопать
буждӧдны	вымыть
бузнитны	хлынуть
буксируйтны	буксировать
буксыны	трубить
буксыны	ухать
букшасьны	хмуриться
букӧстны	прогудеть
букӧстны	ухнуть
букӧстны	пробасить
булькйыны	булькать
булькӧдчыны	булькать
булькӧдчыны	плескаться
бульскакывны	хлюпать
бурасьны	успокоиться
бурасьӧдны	перемирить
бурдыштны	зажить
бурдӧдны	наладить
буритны	бурить
бурлачитны	распутничать
бурмыны	улучшиться
бурсины	благословить
бурӧдавны	перемирить
бушйысьны	драться
бушуйтны	бушевать
бушуйтчыны	свирепствовать
быгавны	увянуть
быгъяссьыны	мылиться
быгыльтны	перенести
быгӧртны	окаймить
быдмывлыны	родиться
быдмыны	разрастаться
быдмыны	дорасти
быдмыны	отрасти
быдтыны	нарастить
быдтыны	вывести
быликтыны	выплюнуть
быравлыны	переводиться
бырзьыны	брюзжать
бырӧдны	отменить
бырӧдны	гасить
бытшйӧдлыны	втыкать
бытшкыны	воткнуть
бытшкыны	сверлить
бытшкыштны	кольнуть
бытшлӧдлыны	прокалывать
бытшлӧдлыны	накалывать
бӧбасьны	дурачиться
бӧрдны	плакать
бӧрдӧдлыны	оплакивать
бӧрйӧдчыны	тягаться
бӧрнясьны	буксовать
бӧрыньтны	отбить
бӧрыньтны	отказаться
бӧрыньтчыштны	попятиться
бӧрӧздаӧссьыны	избороздиться
вазӧбтыны	откусить
ваймыны	гаснуть
ваймыны	постареть
вайӧдавны	приводить
вайӧдавны	пригонять
вайӧдны	привести
ваксьыны	хохотать
валитны	валить
валитны	привалить
валнитны	хлынуть
вальскыны	балагурить
валяйтны	накатать
валяйтсьыны	прокататься
валяйтчыны	валяться
варгыльтчыны	стоптаться
варгылясьны	шататься
варкакывны	потрескивать
варовитны	журчать
варскакывны	хрустеть
вартны	убить
вартны	прибить
вартсьыны	обмолачиваться
варччыны	походить
ватолитны	лепетать
ватшкыны	квакать
вашвидзны	улыбаться
вашъявны	улыбаться
ваявны	рожать
вевдыны	преобладать
вевсьӧдчыны	слиться
вевттьыны	облицевать
вевттьысьыштны	подёрнуться
вевттьыштны	прикрыть
вевттьыштны	подёрнуть
вегльӧдлыны	вилять
ведитны	справить
ведитчыны	вестись
вежвидзны	зеленеть
вежгыны	восхититься
веждыны	приесться
вежлавны	разнообразить
вежлавны	видоизменять
вежлалыштны	разнообразить
вежлалыштны	видоизменить
вежласьны	сменяться
вежласьны	колебаться
вежласьны	спрягаться
вежмасьны	перемежаться
вежмасьны	спорить
вежньӧдлыны	исковеркать
вежсьыны	смениться
вежсьыны	переодеться
вежсьыны	обменяться
вежсьыштны	видоизмениться
вежыньтны	скрестить
вежыньтны	сбить
вежыньтчыны	сбиться
вежӧртсьыны	предполагаться
вежӧсасьны	перегородиться
везъясьны	тянуться
векнявны	сточиться
векыштны	сдвинуть
векыштны	стиснуть
велавны	повадиться
велавны	присмотреться
велавсьыны	понять
велавсьыны	привыкать
венласьны	бороться
венласьны	соревноваться
веньявны	болтаться
веравны	зыбиться
вербуйтны	вербовать
вермасьны	сопротивляться
вермасьны	соперничать
вершитны	вершить
весавны	вылущить
весавны	отхаркиваться
весалыштны	почистить
весалыштны	пополоть
веситчыны	взвешиваться
веськавны	расправиться
веськавны	совпасть
веськӧдлывлыны	править
веськӧдны	обрушить
веськӧдны	переключить
веськӧдны	поправить
веськӧдчыны	опохмелиться
ветлывлыны	ездить
ветлыны	отлучиться
ветлыны	наездить
ветлӧдлыны	циркулировать
ветьӧкавны	подтереть
вечмасьны	кривляться
вешйыны	отойти
вешйыны	сбиться
вешйыны	передвинуться
вешкырасьны	плакать
вешкырасьны	гримасничать
вешкыртчыны	заплакать
вештавны	расплачиваться
вештыны	перенести
вештыны	возместить
вештысьны	расплатиться
вештыштны	отдёрнуть
взорвитны	взорвать
взорвитчыны	взорваться
взрывайтны	взрывать
взрывайтчыны	взрываться
видзаавны	приветствовать
видзаасьны	здороваться
видзны	использовать
видзны	исписать
видзсьыны	содержаться
видзчысьны	сдерживаться
видзыштны	поберечь
видзыштны	подержать
видзыштны	понянчить
видзыштны	попасти
видзӧдны	норовить
видзӧдны	подражать
видзӧдсьыны	смотреться
видзӧдсьыны	просматриваться
видзӧдчыны	норовить
видзӧдчыны	грозить
видлавны	анализировать
видлавсьыны	рассматриваться
видлавсьыны	слушаться
вижавны	желтеть
вижӧдны	зеленеть
визируйтны	визировать
визувтны	оплыть
визьйӧдлыны	исполосовать
вийсьыны	переживать
вильдыны	поскользнуться
вильдыны	выскользнуть
вильдӧдны	поскользнуться
вильсйӧдлыны	скользить
вильскӧбтыны	поскользнуться
винитчыны	согласиться
вины	омертвить
вины	донимать
вины	утолить
виньгыртны	голодать
виньдавны	давиться
виньдавны	захлёбываться
виртӧммыны	обескровиться
виртӧммӧдны	обескровить
висьлыны	переболеть
висьтавлыны	подсказывать
висьтавлыны	предсказывать
висьтавны	сообщить
висьтавны	подсказывать
висьтавны	указать
висьтавны	оповестить
висьтавны	провозгласить
висьтавны	произнести
висьтавны	гласить
висьтавны	толковать
висьтавны	предупредить
висьтавсьыны	говориться
висьтавсьыны	проговориться
висьтасьны	сказываться
вичмыны	достаться
виччысьны	грозить
виччысьны	требовать
вишкыны	всхлипывать
вишкыны	сипеть
вишнитны	всхлипнуть
виявны	сочиться
включитны	включить
воавны	прилетать
водзсасьны	противостоять
водны	залечь
водтӧдны	прибить
вожасьны	тяготеть
воймыны	потемнеть
войтыштны	капнуть
войтӧдлыны	закапать
войтӧдны	запятнать
волнуйтны	волновать
волывлыны	посещать
вольскыны	поскользнуться
вольсыштчыны	разрастись
вомавны	упрекнуть
вомасьны	пререкаться
вомлӧстны	скрестить
воны	дослужиться
воны	причитаться
воны	притечь
воны	прилететь
вооружитны	вооружить
вооружитчыны	вооружиться
вормӧдчыны	заговорить
ворсны	проиграть
ворссьыны	проиграть
ворссьыны	прогадать
воскавны	вощить
восны	блевать
воспитайтны	воспитать
воссьыны	вскрыться
восьтавны	отпирать
восьтавны	вскрывать
восьтыны	вскрыть
вочаавны	возразить
вочаӧдны	чокаться
вошлыны	теряться
вошны	тонуть
воштысьны	добраться
воюйтны	воевать
вувзьӧдчыны	броситься
вувзьӧдчыны	наброситься
вугравны	дремать
вуджравны	мелькать
вужйӧдны	укоренить
вужъясьны	укорениться
вузавлыны	продавать
вузасьны	торговать
вундавны	пилить
вундасьны	изрезаться
вундыны	вырезать
вундыны	отрезать
вундысьны	порезаться
вундыштны	надрезать
вундыштны	резнуть
вунласьны	забываться
вунӧдны	разучиться
вунӧдны	отвыкнуть
вунӧдчывны	забыться
вунӧдчыны	забыть
вушйӧдны	обесцветить
вывтіасьны	переусердствовать
выдайтны	выдать
выймитны	отбить
вылысмыны	подняться
вылыстӧммӧдны	обезжирить
выльдыны	возобновить
выльдыны	реставрировать
выльпӧлавны	пересмотреть
вынсявны	окрепнуть
выпишитчыны	выписаться
выступитны	выступить
вӧвны	оказаться
вӧвны	состояться
вӧдитчыны	эксплуатировать
вӧзйысьны	отпроситься
вӧйлыны	тонуть
вӧймыны	одичать
вӧйны	погрузиться
вӧйтны	затопить
вӧльдъявны	порошить
вӧляасьны	самовольничать
вӧрзьыны	вывихнуться
вӧрзьӧдны	вывихнуть
вӧрзьӧдны	разбередить
вӧрзьӧдны	потрясти
вӧрзьӧдны	надорвать
вӧрны	шевелиться
вӧрны	шататься
вӧрӧдны	трогать
вӧрӧдны	шевелить
вӧрӧдны	двигать
вӧрӧдны	красть
вӧрӧдны	тревожить
вӧснявны	убывать
вӧтлавны	удалять
вӧтлавны	выселять
вӧтлыны	погонять
вӧтлыны	удалить
вӧтлыны	выселить
вӧтлыны	отчислить
вӧтлысьны	гоняться
вӧтлысьны	преследовать
вӧтчыны	угнаться
вӧтчыны	следовать
вӧтӧдны	преследовать
вӧчавны	выделывать
вӧчасьны	кривляться
вӧчны	расчистить
вӧчны	разделать
вӧчны	составить
вӧчны	совершить
вӧчны	образовать
вӧчны	потрошить
гагнырасьны	сверлить
гаддьӧссьыны	пузыриться
гажмыштны	повеселеть
гажтӧмтчыны	бояться
гажӧдны	радовать
газуйтны	газовать
гальскыны	цокать
гаравсьыны	упоминаться
гарантируйтны	гарантировать
гартлыны	всколыхнуть
гартлӧдлыны	крутить
гартовтчыны	покрутиться
гартчыны	виться
гартчыны	извиваться
герчкыны	крякать
гетшкыны	квакать
гижасьны	переписываться
гижйӧдлыны	изрезать
гижнитны	царапнуть
гижны	записать
гижсьӧдны	подписать
гижъясьны	поцарапаться
гижӧдны	прописать
гильӧдчыны	щекотать
гипнотизируйтны	гипнотизировать
гирйыны	протирать
гирйысьны	придираться
гирскыны	шаркать
гирскыны	скрежетать
гирснитны	чиркнуть
гирчкыны	скрежетать
гирчкыны	придираться
гожводзавны	загорать
гольскыны	цокать
горзыны	стонать
горзыны	перекликаться
горзыны	стрекотать
горӧдны	простонать
грымӧдчыны	грохотать
гуасьны	зарыться
гуджгыны	скрестись
гуджгыны	грызть
гудралыштны	помешать
гудралыштны	помесить
гудралыштны	посбивать
гудыртчыны	помрачиться
гужгыны	скрипеть
гузьгысьны	высыпаться
гуляйтӧдны	катать
гургыны	гудеть
гургыны	грохотать
гурйыны	выскребать
гурӧдчыны	тарахтеть
гусьӧнасьны	скрывать
гутшкыны	стучать
гыавны	колыхаться
гыавны	раздаться
гыдъясьны	впутаться
гыжйыштны	царапнуть
гыжйыштны	почесать
гыжъялыштны	почесать
гыжъялыштны	поцарапать
гыжъясьны	царапаться
гыжъясьны	чесаться
гыжъясьны	медлить
гызмасьны	таскаться
гылавны	пасть
гылӧдны	рассыпать
гылӧдны	раструсить
гылӧдны	сорить
гымӧдны	стучать
гынмыны	получиться
гыны	сновать
гырсявны	крупнеть
гӧгыльтчыны	закатиться
гӧгыльтчыны	свернуться
гӧгӧрвоны	одуматься
гӧгӧрвоны	разгадать
гӧгӧртӧдны	обнести
гӧгӧртӧдны	обвести
гӧдитчыны	пригодиться
гӧльтӧдчыны	прибедняться
гӧлявны	бедствовать
гӧлӧзубитны	зубоскалить
гӧлӧзубитны	пустословить
гӧнитны	бежать
гӧнитӧдны	гнать
гӧнсявны	опериться
гӧрддзысьӧдны	опылить
гӧрдитчыны	гордиться
гӧрдлыны	ржать
гӧрдӧдны	буреть
гӧрдӧдны	воспалиться
гӧрны	избороздить
гӧрыштны	откромсать
гӧститӧдчыны	угощать
гӧтравны	женить
дасмындаавны	удесятерить
двӧитчыны	двоиться
дежуритны	дежурить
дезертиравны	дезертировать
действуйтны	действовать
демилитаризируйтны	демилитаризировать
демобилизуйтны	демобилизовать
демобилизуйтчыны	демобилизоваться
дернитны	дёрнуть
джагыдмыны	перечерстветь
джагӧдавны	перегрызть
дженьдыны	укоротиться
дженьдӧдны	сокращать
дженьдӧдчыны	сокращаться
дживкйӧдлыны	жужжать
дживкнитны	прощебетать
дживкнитны	пиликнуть
джуньгыны	лакать
джынъясьны	убавиться
дзабыртны	схватить
дзавйыны	расщепить
дзавйысьны	расщепиться
дзажгыны	жужжать
дзажгыны	трещать
дзажгыны	шуршать
дзажмунны	зашипеть
дзажмунны	затрещать
дзажмунны	зашуршать
дзайгысьны	попрошайничать
дзаравны	рассветать
дзаркнитны	блеснуть
дзеблавны	скрывать
дзеблавны	укрывать
дзеблавны	хоронить
дзебны	укрыть
дзебсьыны	притаиться
дзебсьыны	затаиться
дзебсьыны	хоронить
дзебсьыны	дезертировать
дзебсясьны	прятаться
дзебсясьны	дезертировать
дзенӧдны	бахать
дзерӧдны	обижать
дзибыртчыны	перевернуться
дзивӧдчыны	пищать
дзивӧдчыны	пиликать
дзижмунны	прошипеть
дзижмунны	прожужжать
дзижмунны	пронестись
дзижнитны	обжечь
дзизгыны	гудеть
дзизъявны	сновать
дзирдавны	гореть
дзирдыштлыны	сбегать
дзирдыштны	побежать
дзирдыштны	промелькнуть
дзирмӧдчыны	закалиться
дзирньӧдлыны	вертеть
дзирнясьны	шататься
дзобгыны	тряхнуть
дзобгыны	боднуть
дзобнитны	боднуть
дзоллясьны	капать
дзольгыны	журчать
дзоляммыны	уменьшиться
дзоньтавны	восстанавливать
дзоньтыны	восстановить
дзоридзавны	цвести
дзорӧдны	оттаскать
дзуглыны	перепутать
дзугльӧдлыны	тошнить
дзугсьыны	взъерошиться
дзугсьыны	дезориентироваться
дзугсьыны	сбиться
дзужгыны	шипеть
дзужгыны	скрипеть
дзужнитны	обжечь
дзужъявны	ездить
дзулькнитны	выплеснуть
дзумйӧдлыны	окунать
дзумӧдны	щекотать
дзуркнитны	скрипнуть
дзурликтыны	курлыкать
дзурскысьны	провалиться
дзуртны	скрипеть
дзуртыштлыны	поскрипывать
дзуртыштны	скрипнуть
дзӧрны	шататься
дзӧрыштны	потрястись
дивуйтчыны	недоумевать
дикуйтчыны	дурачиться
дирижируйтны	дирижировать
довгыны	ударить
довйӧдлыны	раскачивать
довйӧдлыны	кивать
доддясьны	запрягать
дойдны	обидеть
дойдны	резать
доказывайтны	доказывать
долыдавны	радоваться
домавны	приковать
донтӧммӧдны	обесценить
донъявны	уважать
донъявсьыны	цениться
донӧдны	обжечь
допроситны	допросить
дорйыны	защитить
дорны	заковать
дорны	подковать
дорны	приковать
дорны	сковать
дорыньтчывны	покоситься
дорыньтчыны	покоситься
другасьны	брататься
дружитны	дружить
дружитчыны	подружиться
дрӧгйӧдлыны	вздрагивать
дуанитны	упрямиться
дубитны	дубить
дубитчыны	задубеть
дугдыны	пройти
дугдыны	расхотеть
дугдыны	выключиться
дугӧдлыны	приостановить
дугӧдны	прервать
дугӧдны	прекратить
дугӧдны	оторвать
дугӧдны	отклонить
дугӧдны	отменить
дугӧдчыны	выключиться
дудны	застояться
дудӧдны	остановить
дузгӧдчыны	насупиться
дукӧссьыны	пропахнуть
думайтны	допускать
думайтны	вообразить
думайтны	мнить
думайтны	судить
думыштны	вообразить
думыштны	представить
дурмыны	разбушеваться
дыгыдасьны	сетовать
дыгыдмыны	облениться
дыгыдмыны	отвыкнуть
дыгӧдны	надоесть
дякӧнавны	дьяконствовать
дізьӧдчыны	резвиться
дільсмунны	помутнеть
дільӧдчыны	дразниться
дітшкӧдны	бахать
дӧбӧдчыны	шевелиться
дӧввидзны	белеть
дӧверяйтны	доверять
дӧжнасьны	беспокоиться
дӧзмӧдчыны	дразнить
дӧзьӧритны	ухаживать
дӧлӧдны	колыхать
дӧмасавны	подшить
дӧнзьыны	достаться
еддзыны	распутничать
еджвидзны	белеть
едъявны	колыхаться
емасьны	колоться
епископавны	епископствовать
жаритны	печь
жбыракывны	порхать
жвучкыны	свистеть
желлявны	занозить
жервидзны	зиять
жергӧдны	оскалить
жергӧдчыны	разинуться
жермунны	улыбнуться
жермунны	оскалиться
жеръявны	зиять
жмитны	прижать
жмотйӧдлыны	валить
жнячйӧдлыны	шмякать
жуглыны	ломать
жугӧдны	побить
жуйвидзны	прозябать
жукайтны	раздумывать
жулльыны	разрушить
жульничайтны	жульничать
жулясьны	расщепиться
жуны	роиться
жуньгыны	гудеть
жуньгӧдны	нести
жунькнитны	прогудеть
жунькнитны	прожужжать
жунькнитны	пронестись
жунькъявны	проноситься
жунякывны	гудеть
жургыны	журчать
жургыны	гудеть
журӧдчыны	журчать
жӧвъявны	слоняться
жӧвъявны	забываться
забастуйтны	забастовать
забедуйтны	обижаться
заборитчыны	перегородиться
забронируйтны	забронировать
завещайтны	завещать
заводитлыны	начинать
завоюйтны	завоевать
заготовитны	заготовить
заготовляйтны	заготовлять
заимствуйтны	заимствовать
займитны	занять
заптысьны	запасаться
запутайтчыны	запутаться
запутайтчыны	затеряться
зарадитчыны	заряжать
зарадитчыны	заряжаться
зарниӧдны	озолотить
заседайтны	заседать
зачтитны	зачесть
збыльмыны	подтвердиться
згӧдитчыны	пригодиться
здоровмыны	поправиться
зевайтны	зевать
зевайтны	прозевать
зульӧдны	тыкать
зумыдмӧдны	укрепить
зумышвидзны	хмуриться
зурӧдны	переть
зурӧдчыны	колоться
зутшкыны	толочь
зывгыны	ныть
зывӧкмыны	опротиветь
зымгыны	грохотать
зымгыны	отгрохать
зымӧдчыны	стучаться
зыньгыны	пищать
зыравны	массировать
зырсьыны	тесниться
зыртчыны	тереться
зыртчыны	протереться
зычитны	враждовать
зьвагитны	обличать
зэвтны	напрячь
зэлавны	натянуться
зэлӧдавны	натягивать
зэлӧдавны	затягивать
зэлӧдавны	напрягать
зэлӧдлыны	натянуть
зэлӧдны	натянуть
зэлӧдны	затянуть
зэлӧдны	подтянуть
зэлӧдны	закрутить
зэлӧдны	обостриться
зэлӧдыштны	подтянуть
зяткакывны	лязгать
зяткыны	лязгать
зёлькмунны	звякнуть
зёльӧдчыны	звенеть
зёлякывны	звякать
зільмӧдны	усилить
зільмӧдчыны	постараться
зільны	стремиться
зӧркнитны	стукнуть
идеализируйтны	идеализировать
измӧдны	ожесточить
изолируйтны	изолировать
изсьыны	перемолоться
изсьыны	износиться
изьведитны	загубить
икайтны	гикать
имитны	сбыться
инасьны	успокоиться
индустриализируйтны	индустриализировать
индыны	ориентировать
индыны	выдвинуть
индыссьыны	указываться
инструктируйтны	инструктировать
интересуйтны	интересовать
интересуйтчыны	интересоваться
информируйтны	информировать
иславны	кататься
исласьны	кататься
исправитны	выправить
исследуйтны	исследовать
ичӧтмыны	разукрупниться
йигӧртны	осязать
йиджтысьны	проникнуть
йиджтысьны	проникнуться
йизьыны	заледенеть
йиркйӧдлыны	грохотать
йиркнитны	загреметь
йирны	щипать
йирны	скрежетать
йирыштны	пощипать
йирыштны	заскрежетать
йитны	сшить
йитны	сплести
йитчавны	соединяться
йитчавны	срастаться
йитчавны	связываться
йитчыны	срастись
йитчыны	связаться
йитшкыльтны	подвернуть
йитшкыльтчыны	свернуться
йывмыны	заостриться
йывмӧдны	расплодить
йӧжгыльвидзны	ёжиться
йӧжгылясьны	прислуживаться
йӧзтӧммыны	обезлюдеть
йӧймыны	неистовствовать
йӧйявны	блуждать
йӧйявны	растеряться
йӧлавны	забелить
йӧршитны	арестовать
йӧршитны	локализовать
йӧршитчавны	забиваться
йӧршитчавны	замыкаться
йӧршитчыны	замкнуться
йӧткавны	толкать
йӧткавны	отталкивать
йӧткалыштны	потолкать
йӧткыны	толкать
йӧткыны	гнать
йӧткыны	передвинуть
йӧткыны	выколотить
йӧткыны	сбить
йӧткыштны	продвинуть
йӧткыштчыны	отчалить
йӧткыштчыны	вдвинуться
кабыртны	схватить
кабыртны	сгрести
казнитны	казнить
казьтывны	упоминать
казьтывны	поминать
казьтыштны	вспомнить
казьтыштны	упомянуть
казьтыштны	напомнить
казьтыштны	припомнить
казявлыны	замечать
казявлыны	наблюдать
казявны	спохватиться
каймӧдлыны	уговаривать
кайны	набежать
кайны	вскочить
кайтны	повторять
какнюрасьны	кувыркаться
калечитны	искалечить
калскӧбтыны	стукнуть
калскӧбтыны	щёлкнуть
калскӧдны	стукать
калскӧдны	щёлкать
калскӧдчыны	стучать
калькмунны	приоткрыться
камдуйтны	командовать
камӧбтыны	грохнуть
камӧдны	стучать
канителитчыны	канителиться
каннявны	тереться
кантавны	кантовать
капитулируйтны	капитулировать
карасьны	гримасничать
кардъявны	гипсовать
каркъявны	кашлять
карчкакывны	хрустеть
карчкӧдны	щёлкать
карчкӧдны	грызть
кассясьны	царапаться
катлавны	шевелиться
катласьны	шататься
катласьны	качаться
катлыны	поднимать
катовтны	наклонить
катовтны	перевалить
катовтчыны	склониться
катовтӧдны	склониться
каттьысьны	подниматься
катшъявны	озорничать
катӧдны	поднять
катӧдны	привести
качайтчыны	качаться
качыштлыны	качнуть
квайтпӧвставны	ушестерить
квайтпӧвстасьны	ушестериться
квалифицируйтны	квалифицировать
кватлавны	хватать
кватлавны	нахватать
кватлавны	расхватать
кевмыны	пожелать
кевмыны	исповедовать
кевмысьны	кланяться
кевны	брести
кевны	перебрести
кедзовтны	обижать
кежны	забрести
кежны	посторониться
кежны	отступить
кежыштны	отодвинуться
кежыштны	уклониться
кежӧдны	завернуть
кежӧдны	отвести
кежӧдны	отвлечь
кежӧдчыны	оставить
кезнитны	содрогнуться
кезнитны	передёрнуться
кезъявны	передёргиваться
келавны	бродить
кельдӧдны	обесцветить
кельӧдны	калить
кепыльтчыны	корёжиться
керавлыны	нарубить
керавны	изгрызть
керассьыны	пораниться
керны	потрошить
керсьыны	вытворять
керсьыны	сделаться
керыштны	отрубить
керыштны	нарубить
кесъявны	угождать
кетшавны	заикаться
кизявны	застегнуть
кизявны	пристегнуть
кикурвидзны	бездельничать
кильксьыны	хихикать
кимӧститчыны	манипулировать
кинясьны	искриться
киритны	списать
кирчижитчыны	привередничать
кирчкыны	щёлкать
киськавны	поливать
киськассьыны	раструситься
кисьтавны	раструсить
кисьтны	провалить
кисьтны	выбить
кисьтны	заливаться
китшкӧбтыны	хихикнуть
китшсьыны	хихикать
китшъявны	хихикать
клеявны	проклеивать
клеясьны	прилипнуть
клопйӧдлыны	хлопать
клотшкыны	хрустеть
клювкйӧдлыны	курлыкать
кляпкыны	сболтнуть
клёнгысьны	стукнуться
клёнӧбтыны	стукнуть
клёнӧдны	стучать
клёнӧдчыны	стукаться
клӧкӧбӧритны	крохоборничать
ковгыны	трещать
ковмунны	затрещать
ковмывны	приходиться
ковмыны	прийтись
ковӧдчыны	трещать
коддзӧдавны	перепоить
кодзулӧссьыны	вызвездить
кодйыштны	подолбить
кодъявны	перерыть
койны	изрыгать
койсьыны	брызгаться
койтлыны	токовать
койтны	токовать
койыштны	брызнуть
кокалыштны	поклевать
кокалыштны	подолбить
кокасьны	клевать
кокасьны	мотыжить
кокасьны	долбить
кокасьны	клеваться
кокны	окучивать
кокньӧдны	помогать
кокньӧдны	смягчить
кокньӧдны	упростить
кокньӧдны	освежить
кокорнитчыны	обмануться
кокошитны	избить
коксьыны	мотыжить
коктӧммыны	охрометь
кокыштны	клюнуть
кокӧдны	кувыркнуть
коллективизируйтны	коллективизировать
колльыны	сопровождать
колльӧдны	сопровождать
колсйӧдлыны	нащёлкать
колскӧдны	щёлкать
колскӧдчыны	стучать
кольмыны	угореть
кольмыны	охмелеть
кольны	остаться
кольны	отстать
кольны	сохранить
кольны	сохраниться
кольччыны	остаться
кольӧдны	удержать
колявны	оставлять
колявны	оставаться
колявны	пропускать
командуйтны	командовать
комбыльтны	выгнуть
конйыштчыны	споткнуться
конспектируйтны	конспектировать
контрактуйтны	контрактовать
контролируйтны	контролировать
контузитны	контузить
конфискуйтны	конфисковать
конъясьны	запнуться
кооперируйтны	кооперировать
координируйтны	координировать
копируйтны	копировать
копошитчыны	копошиться
копрасьны	кланяться
копрӧдлыны	качать
копыртчыштлыны	кивнуть
корасьны	свататься
коргыны	храпеть
коркаавны	переплести
корлыны	пригласить
кормыны	заскорузнуть
корны	приглашать
корны	требовать
корны	ходатайствовать
корсьны	искать
корчуйтны	корчевать
корысявны	нищенствовать
корӧсявны	парить
корӧсясьны	париться
коставлыны	прерваться
костӧдны	прервать
косьмыны	обсыхать
косьмыны	присыхать
косьмыны	отсыхать
косьмыны	насохнуть
косьтыны	обсушить
косявны	разорить
косявны	ударить
косясьыштны	подраться
косӧдны	обсушить
косӧдчыны	обсушиться
котравны	пробегать
котыртлывлыны	организовывать
котӧртлыны	сбегать
коясьны	брызгаться
крапкыны	брякнуть
крапкысьны	захлопнуться
кратайтчыны	капризничать
кредитуйтны	кредитовать
крепаммыны	упрочиться
крепитны	упрочить
креставны	перекрестить
крестасьны	переплестись
крестасьны	заплетаться
креськысьны	грохнуться
кривзыны	курлыкать
кривксьыны	курлыкать
критикуйтны	критиковать
кронӧдны	хрустеть
крукасьны	зацепиться
круксыны	каркать
крукыльтны	скрутить
крукыштны	зацепить
крукыштчыны	зацепиться
кувйӧдлыны	палить
кувны	замереть
кудзасьны	мочиться
кузькиасьны	воровать
кузьмӧдны	удлинить
кузьмӧсмыны	вытянуться
куимавны	троиться
куимпӧвставны	утроить
куйлыны	лежать
куканясьны	отелиться
кулавны	вымирать
кулитчыны	жаловаться
кульмӧдны	нерестовать
кульсьыны	раздеваться
куньтыртлыны	подмигнуть
куражитчыны	куражиться
кургыны	мурлыкать
курдӧдны	горчить
куритчыны	курить
куркнитны	ворковать
курксыны	каркать
курликтыны	курлыкать
куртыштны	снимать
курчкӧдны	лущить
курччалыштны	покусать
курччалыштны	пожевать
курччасьны	кусаться
курччасьны	шерстить
курччыны	перекусить
курччыштны	пожевать
куснясьны	модничать
кустарничайтны	кустарничать
кусыньмунны	согнуться
кусыньтны	склониться
кусӧдны	выключить
кутавны	обнимать
куткырасьны	ёжиться
куткырасьны	ютиться
кутлыны	подержать
кутлыны	пожать
кутны	обнять
кутны	иметь
кутны	содержать
кутны	выдержать
куттьыны	хихикать
кутчысьлыны	подержаться
кутчысьлыны	хватать
кутчысьлыны	обниматься
кутчысьны	обняться
кутыштлыны	подержать
кутыштлыны	обнять
кучкыны	стегнуть
кучкыны	поразить
кучкыны	причитаться
кушмӧдны	вырубить
кывберитны	острить
кыввежыньтны	возразить
кывзыштны	послушать
кывлывлыны	слыхивать
кывны	осязать
кывны	внять
кызны	утолститься
кызны	кашлять
кызӧктывны	покашливать
кызӧктӧдны	кашлянуть
кыйгыны	высматривать
кыйкъявны	озираться
кыйны	ловить
кыйны	охотиться
кыйявны	бодрствовать
кыкбанасьны	лицемерить
кылавны	уплыть
кылавны	закатываться
кылыштны	слышать
кылыштны	потягивать
кылӧдны	закатить
кылӧдчыны	пробираться
кымрасьны	хмуриться
кымӧдчыны	заслонять
кымӧртчыны	помрачнеть
кынтыны	простудить
кынтыны	сковать
кыптыны	вырасти
кыптыштны	приподняться
кыпъявсьыны	дышаться
кыпыдмыны	оживиться
кыпыдмыны	вдохновиться
кыпӧдны	вызвать
кырлавны	потрошить
кырсавны	распутничать
кырсасьны	гулять
кырыштны	вскрыть
кырыштчыны	напороться
кырыштчыны	порезаться
кыскалыштны	потаскать
кыскалыштны	повыдёргивать
кыскалыштны	повозить
кыскалыштны	потягивать
кыскасьны	ползать
кыскыны	свести
кыскыссьыны	привлекаться
кыскыштавны	подвозить
кыскыштавны	потягивать
кыскыштны	подвезти
кыскыштны	потянуть
кыскыштны	затянуться
кыссьыны	загустеть
кыссьыны	пролегать
кытшавны	обступать
кытшкылясьны	ютиться
кытшкылясьны	торчать
кытшлӧдлыны	кружить
кытшовтны	обвести
кытшовтӧдны	обнести
кышны	обложить
кышсьыны	покрыться
кӧвтны	снимать
кӧвъявны	связать
кӧдзны	засеять
кӧдзны	усеять
кӧдзӧдчыны	прохладиться
кӧжмавны	сглазить
кӧзырайтны	козырять
кӧзяинавны	хозяйничать
кӧйвидзны	торчать
кӧйгӧдчыны	присесть
кӧкны	куковать
кӧлачасьны	округлиться
кӧлыштны	хлебнуть
кӧлыштны	схватить
кӧнӧбоитчыны	барышничать
кӧрлыны	насупить
кӧрлӧдлыны	морщить
кӧрлӧдлыны	насупить
кӧрпитны	корпеть
кӧртавлыны	повязывать
кӧртавлыны	привязывать
кӧртавны	повязать
кӧртавны	связать
кӧртавны	привязать
кӧртавны	шнуровать
кӧртавны	сковать
кӧртасьны	повязаться
кӧртасьны	связаться
кӧртвомавны	взнуздать
кӧртвомавны	обуздать
кӧртымавны	арендовать
кӧртыштны	повязать
кӧртыштны	обвязать
кӧртыштны	связать
кӧртыштны	привязать
кӧрӧстуйтчыны	поживиться
кӧсйыссьыны	хотеться
кӧсйысьны	обязаться
кӧсӧймыны	окосеть
кӧтасьны	размокнуть
кӧтасьны	замокнуть
кӧтӧдны	промочить
кӧтӧдны	промокать
кӧтӧдсьыны	мочиться
кӧтӧдчыны	мочить
кӧявны	кочевать
ладмыны	спеться
лажъявны	приседать
лажъявны	слоняться
лазгӧдны	потупить
лайкнитны	кивнуть
лайкъявны	колыхаться
лайкъявны	шататься
лайкӧдны	качать
лаймавны	догорать
ланьтыштны	замолкнуть
ланьтыштны	притихнуть
ланьтӧдны	утишить
ланьтӧдчыны	притихнуть
ланьтӧдчыны	притаиться
ланьтӧдчыны	успокоиться
лапнитны	хлопнуть
легзьыны	зашататься
легнитны	шатнуть
легнитны	шевельнуть
легнитны	вильнуть
легны	шататься
легны	шевелиться
легны	топтаться
легӧдны	шевелить
легӧдны	вилять
легӧдыштны	пошатать
легӧдыштны	потрясти
лезны	жевать
лелькуйтчыны	церемониться
лепитчыны	взгромоздиться
лепитчыны	прилепиться
лепитчыны	держаться
лестукавны	расщеплять
лестукасьны	расщепиться
летйӧдлыны	таскать
летйӧдлыштны	помотать
летйӧдлыштны	потаскать
летъявны	перемогаться
лечитчыны	лечиться
лешсьыны	издёргаться
ликтыны	указать
линьгыртчыны	подогнуться
лихорадитны	лихорадить
личкыны	выдавить
личлэдзчысьны	расслабиться
личӧдчыны	расслабиться
ловзьыны	выжить
локны	явиться
локтавны	возвращаться
локтавны	являться
лолавсьыны	дышаться
лолыны	возникать
лолыны	происходить
лолыштны	проветриться
ломавны	пылать
ломавны	гореть
ломзьыны	засветиться
ломзьӧдны	зажечь
ломтыны	истопить
ломтыссьыны	истопиться
ломтысьны	гореть
ломтысьны	топиться
лоны	быть
лоны	выйти
лоны	прийтись
лотайтны	деть
лотшкыны	хрустеть
лыбавны	вздыматься
лыддьыны	насчитать
лыддьыны	приписать
лыддьысьны	насчитываться
лыддявны	перечитать
лызгыны	ныть
лыйлыны	стрелять
лыйны	выстрелить
лыйсьыны	стрелять
лыйсьыны	отстреливаться
лыйсьыны	перестреливаться
лысьтыны	доиться
лытайтны	скитаться
лэбавны	летать
лэбавны	налетать
лэбавны	носиться
лэбалыштны	полетать
лэбыштны	махнуть
лэдзавны	выпускать
лэдзавны	спускать
лэдзавны	фабриковать
лэдзавны	опустить
лэдзны	запустить
лэдзны	отложить
лэдзсьыны	издаваться
лэдзыштны	припустить
лэптавны	поднимать
лэптавны	подоткнуть
лэптасьны	подтягиваться
лэптыны	произвести
лэптыштны	поддёрнуть
лэчтасьны	оттачивать
лэччыны	течь
лэччыны	падать
лэччӧдлыны	спускать
любитчыны	влюбиться
любуйтчыны	любоваться
любуйтчыштны	полюбоваться
любуйтчыштны	понаслаждаться
лювзыны	выть
лювъявны	колыхаться
люзьвидзны	свисать
люзьгӧдчыны	растянуться
люзьявны	таскаться
люкасьны	бодаться
люньгыртчыны	никнуть
люньявны	слоняться
люнявны	обессилеть
лябсьыны	жаловаться
лявзыны	тявкать
лявзыны	выть
ляксьыны	замешаться
лямавны	раздавиться
ляскыны	бросить
ляскысьны	лепиться
ляскӧдчыны	ластиться
ляскӧдчыны	сплетничать
лёгсьыны	примяться
лёзьгӧдны	распустить
лёзьгӧдчыны	сваляться
лёкмӧдны	обострить
лёкмӧдны	ухудшить
лёллявны	свисать
лӧвтны	хныкать
лӧгасьны	обижаться
лӧзавны	синеть
лӧзавны	голубеть
лӧзӧдыштны	поголубеть
лӧнявны	успокаиваться
лӧсасьны	обтёсываться
лӧставны	блестеть
лӧсьӧдавны	организовывать
лӧсьӧдлыны	укладывать
лӧсьӧдны	подставить
лӧсьӧдчыны	метить
лӧсьӧдчыны	намереваться
лӧсьӧдчыны	норовить
лӧсьӧдыштны	переделать
лӧсьӧдыштны	доделать
лӧсявны	оказаться
лӧсявны	помогать
мавтны	льстить
мавтыштны	польстить
магнитавны	намагнитить
майкны	топтать
майксьыны	толочься
майксьыны	топтаться
майтӧгасьны	намылиться
майшасьны	сомневаться
макнитны	махнуть
малавлыны	гладить
малалыштны	погладить
малскыны	жевать
маневрируйтны	маневрировать
манитлыны	задерживать
маршируйтны	маршировать
матайтны	мучить
матысмыны	приближаться
матыстчавны	придвигаться
матыстчыны	подступиться
мездавны	освобождать
мездавны	увольнять
мездмыны	освободиться
мездыны	освободить
меліавны	ласкать
меліаммыны	смягчиться
мерайтны	мерить
мерайтчыны	мериться
меткыльтчыны	извернуться
механизируйтны	механизировать
мечтайтны	мечтать
мешайтны	мешать
митингуйтны	митинговать
мичмӧдчыны	нарядиться
мобилизуйтны	мобилизовать
мобилизуйтчыны	мобилизоваться
мовкнитны	хлестнуть
мовкнитны	качнуть
могмӧдны	удовлетворить
могмӧдны	обеспечить
модернизируйтны	модернизировать
мойдны	рассказывать
мольӧдчыны	побриться
мортасьны	встретиться
мортъяммыны	поправиться
мортъяммыны	похорошеть
мортъяммыны	исправиться
мотивируйтны	мотивировать
мошенничайтны	мошенничать
мудйыны	окучивать
мудйыны	окапывать
музгыльтчыны	подвернуться
мунны	ударить
муныштны	подвинуться
муравны	урчать
муравны	рокотать
муравны	бушевать
муракывны	рокотать
мургыны	мурлыкать
мургыны	гудеть
мургыны	бушевать
мургыны	рокотать
мургыштны	помурлыкать
мурзыны	урчать
муркакывны	рокотать
муркнитны	пророкотать
муртсасьны	меряться
мурчкыны	жевать
мурӧстлывлыны	порыкивать
муткыльтны	бурлить
муткылявны	ворочать
муткырасьны	бурлить
муткырасьны	клубиться
муткыртны	клубиться
мутшкыны	жевать
мутшкӧдны	похрустывать
мутшмыны	влажнеть
мущайтчыны	отвлекать
мущайтчыны	мешаться
мыжмыны	провиниться
мыжмӧдчыны	повиниться
мызгыртчыны	съёжиться
мыкрасьны	наклоняться
мыктавны	заикаться
мыктавны	мямлить
мыкӧстны	заикнуться
мыкӧстны	промычать
мынны	освободиться
мынны	развязаться
мынтыны	выпустить
мынтыны	избавить
мынтыны	искупить
мынтыны	отплатить
мырддьыны	отбить
мырддявны	отбивать
мырксьыны	надрываться
мырксьыны	суетиться
мыськавны	хлестать
мытшавны	запнуться
мытшасьны	запнуться
мытшъявны	заикаться
мыччавны	подавать
мыччасьны	пробиваться
мыччывны	протянуть
мыччыны	подать
мыччыны	протянуть
мыччыны	поднести
мыччысьны	обнаружиться
мыччысьыштны	выступить
мыччысьыштны	пробиться
мыччӧдлыны	показывать
мыччӧдлыны	предъявлять
мыччӧдлыны	свидетельствовать
мыччӧдны	предъявить
мӧвкнитны	качнуть
мӧвкнитны	размахнуться
мӧвкнитны	промелькнуть
мӧвпавны	мечтать
мӧвпыштны	подумать
мӧдны	собираться
мӧдпӧвставны	сдвоить
мӧдӧдавны	переселять
мӧдӧдчывны	собираться
мӧмляйтны	медлить
наградитны	наградить
нажӧвитчыны	зарабатывать
назгыны	гнусавить
нардъявны	приварить
нартитчыны	издеваться
настроитны	настроить
национализируйтны	национализировать
наянитны	ухищряться
небзьыны	размягчиться
небзьыны	смягчиться
небзьыны	распариться
небзьыштны	смягчиться
нежитчыны	изнежиться
немуджтӧмавны	бездельничать
немӧстыны	недолюбливать
немӧстыны	ненавидеть
немӧявны	молчать
несъявны	чихать
нетшкыны	дёргать
нетшыштны	отдёрнуть
нетшыштчыны	вырваться
нетшыштчыны	оторваться
никелируйтны	никелировать
нильзьыны	ослизнуть
нимвидзны	заговорить
нимкодясьны	восхищаться
нимъясьны	хвастаться
ниртны	тереть
ниртыштны	потереть
ничьявны	хлюпать
новлӧдлыны	водить
нокайтны	поддакивать
ноксьыны	суетиться
ноксьыштны	похлопотать
норасьны	жаловаться
нормируйтны	нормировать
нормыны	загрустить
нормыны	умилиться
нормӧдны	умилить
нуждайтчыны	нуждаться
нуны	вести
нургыны	мурлыкать
нускыны	сопеть
ныргормунны	всхрапнуть
нырисасьны	принюхиваться
нырны	давить
ныръявны	упрямиться
ньылыштны	поглотить
ньылӧмтӧммӧдны	обезжирить
нэммӧдны	увековечить
нэрмыны	слабеть
нювсьыны	облизываться
нювсьыны	лизаться
нюжавны	тянуться
нюжвидзны	раскинуться
нюжгысьны	растянуться
нюжйӧдлыны	растягивать
нюжйӧдлыны	протягивать
нюжйӧдлыны	высунуть
нюжмасьны	медлить
нюжъявны	растягиваться
нюжӧдны	высунуть
нюжӧдны	затянуть
нюжӧдны	продлить
нюжӧдны	удлинить
нюжӧдчыны	растянуться
нюжӧдчыны	пролегать
нюкрасьны	корчиться
нюкрасьны	мяться
нюкрӧдлыны	сгибать
нюкыльтны	согнуть
нюкыльтчыны	согнуться
нюкыртны	согнуть
нюкыртны	сжать
нюмыртчывны	ухмыльнуться
нюрзьыны	заболачиваться
нюрсмунны	похудеть
нюшкыны	нюхать
нюшкыны	сопеть
нюшкыны	выиграть
нюшкыштны	потащить
нявзыны	мяукать
няжӧдчыны	пиликать
нязакывны	хрустеть
нязмунны	хрустнуть
няклявны	мять
няклявны	пережёвывать
някравны	и
нямравны	подмять
нямыльтны	прошамкать
нярмыны	опустеть
нярмыны	захныкать
нярталаавны	заарканить
няръявны	наяривать
нятшкыны	сосать
нятшкыны	жевать
нёльпӧвставны	учетверить
нёньыштны	пососать
нёнявны	сосать
нёнясьны	сосать
нёровтчыны	прилечь
нёрпавны	недомогать
нӧбавны	намести
нӧрӧвитны	переждать
нӧшасьны	драться
обжалуйтны	обжаловать
обмундируйтны	обмундировать
оборудуйтны	оборудовать
овлывлыны	бывать
овлыны	бывать
овлыны	побыть
овмӧдчавны	обзаводиться
овмӧдчавны	зажить
овмӧдчыны	нажиться
овмӧдчыны	зажить
овны	бодрствовать
ожманасьны	воевать
ойгыны	жалеть
ойдны	разливаться
ойдны	наполниться
ойдӧдны	наводнить
ойӧстны	охнуть
ойӧстыны	обессилеть
окайтны	охать
окйӧдлыны	охать
оккупируйтны	оккупировать
окнитны	охнуть
октыны	насторожить
октыны	взвести
окӧстны	охнуть
олыштны	пожить
олыштны	побыть
омӧльтчыны	слабеть
онишмунны	разомлеть
оправдайтны	оправдать
оправдайтчыны	оправдаться
оравлыны	прекращаться
оравлыны	прерываться
ордйӧдавны	обгонять
ордйӧдавны	обходить
ордйӧдчыны	обходить
ордъявны	перегонять
ордъявны	обходить
ордъявны	обносить
орлыны	обрываться
орлыны	истощиться
орны	распилиться
орны	исхудать
орны	сорваться
орччаасьны	поравняться
оръясьны	прерываться
орӧдны	прорвать
орӧдны	сорвать
орӧдны	истощить
орӧдчыны	сорваться
орӧдчыны	рваться
орӧдчыны	надрываться
отсавны	способствовать
отчитайтчыны	отчитаться
отчитывайтчыны	отчитываться
оформитны	оформить
очмунны	вздрогнуть
ошкыны	одобрять
павтыравны	раскидывать
павтыртны	задрать
павтыртчыны	задраться
павъявны	болтаться
павъявны	развеваться
павъявны	разлетаться
пагӧдны	усыпить
падмыны	затормозиться
падмӧдчыны	отвлекать
падуявны	кантовать
падуявны	кувыркать
падуясьны	кувыркаться
пактӧдны	выпаривать
пактӧдны	уварить
палитны	распялить
палявны	разгуляться
панлавны	перебивать
панлавны	отговаривать
панласьны	соперничать
панлыны	затевать
панны	развязать
пансьыны	основаться
пансьыны	разыграться
паныдавны	возразить
паныдасьлыны	соприкасаться
паныдасьӧдны	столкнуть
паньыштны	хлебнуть
панясьны	хлебать
панясьны	оттачивать
парквартны	побить
парсасьны	царапаться
партизанавны	партизанить
пасибӧасьны	отблагодарить
пасйыны	регистрировать
пасйыны	засечь
пасъявны	маркировать
пасъявны	регистрировать
пасынкуйтны	пасынковать
пасьвартны	разнести
паськавны	развиваться
паськавны	разрастаться
паськавны	расплываться
паськавны	разлиться
паськӧдлыны	раздувать
паськӧдны	раздвинуть
паськӧдны	задёрнуть
паськӧдны	популяризовать
паськӧдчыны	распространяться
паськӧдчыны	разомкнуться
паськӧдчыны	возвышаться
патрулявны	патрулировать
патурликасьны	кувыркаться
пашкыртчыны	распушиться
пашкыртчыны	кудрявиться
певкйыны	избить
пелявны	расщеплять
пемыдгорулавны	сумерничать
перечислитны	перечислить
перйыны	стянуть
перйыны	копать
перъявны	снимать
перъявны	взимать
песлалыштны	постирать
песлалыштны	помять
песлассьыны	отстираться
песлӧдлыны	корёжить
песлӧдлыштны	поломать
песлӧдлыштны	скрутить
песовтны	согнуть
песовтны	совладать
песовтчыны	повернуть
пестыны	раскурить
песыштны	размять
песыштны	промять
петавлыны	взойти
петавны	сходить
петкӧдлыны	выносить
петкӧдлыны	имитировать
петкӧдлыны	предъявить
петкӧдлыссьыны	изображаться
петкӧдны	вывезти
петкӧдны	выкинуть
петкӧдны	выкатить
петкӧдны	экспортировать
петкӧдчыны	отразиться
петкӧдчыны	предстать
петны	выехать
петны	поспеть
петны	причитаться
петны	пахнуть
петшӧравны	жалить
печатайтны	запечатать
печиктыны	щёлкнуть
печлавны	перебирать
пикируйтны	пикировать
пикнитны	пикнуть
пилитны	пиликать
пируйтны	кутить
писькӧдлыны	точить
писькӧдны	пробурить
писькӧдны	слабить
писькӧдчыны	прорыться
письмӧасьны	переписываться
пломбируйтны	пломбировать
плӧтничайтны	плотничать
повторитны	повторить
повторяйтны	повторять
подпишитны	подписать
подпишитчыны	подписаться
подражайтны	подражать
пожъявны	промыть
пожъявны	смыть
пожъясьны	обмыться
поздысьны	роиться
полируйтны	полировать
польскӧдчыны	плескаться
помавны	исчерпать
помасьны	разрешиться
помнитлыны	попомнить
помнитны	помнить
пондывны	пытаться
понъясьны	сквернословить
поромитчыны	запружаться
посйысьны	гатить
посньӧдлыны	разукрупнять
посньӧдны	разменять
поткӧдлыны	лущить
поткӧдны	расколоть
поткӧдны	расщепить
поткӧдны	прорезать
поткӧдны	разорвать
поткӧдны	раздирать
потласьны	колоться
потласьны	лопаться
потласьны	изорваться
потны	расколоться
потны	лопнуть
потны	разорваться
потны	ломить
потны	прорезаться
потшны	отрезать
потшсьыны	отгородиться
пошкӧдчыны	насторожиться
правитны	править
практикуйтны	практиковать
практикуйтчыны	практиковаться
предайтны	предать
предложитны	предложить
председателявны	председательствовать
представитны	представить
представляйтны	представлять
премируйтны	премировать
преобразуйтны	преобразовать
преследуйтны	преследовать
прессуйтны	прессовать
приватизируйтны	приватизировать
призывайтчыны	призываться
прикажитны	приказать
приколитны	приколоть
прикрепитны	прикрепить
присвоитны	присвоить
пробкаасьны	закупориться
провалитны	провалить
провалитчыны	провалиться
пропагандируйтны	пропагандировать
пропишитны	прописать
пропишитчыны	прописаться
проповедуйтны	проповедовать
проявитны	проявить
проявитчыны	проявиться
пружинитны	пружинить
прыссьыны	прыскать
прыссьыны	мчаться
прӧверитны	сверить
прӧверитны	пробовать
прӧверяйтны	проверять
прӧзевайтны	прозевать
прӧйдитны	протекать
прӧймитны	въесться
прӧкиритны	притворяться
прӧстмыны	освободиться
прӧступитны	оступиться
прӧступитны	просчитаться
прӧтивитны	опротиветь
пугрӧдлыны	раздувать
пузьыны	спечься
пузьыны	получиться
пузьӧдны	палить
пузьӧдны	обметать
пукавлывлыны	сиживать
пукавсьыны	сидеться
пукавсьыны	засидеться
пуклӧсавны	оседлать
пуксьывны	наступать
пуксьыны	установиться
пуксьыны	вестись
пуксьӧдны	приземлить
пуктавны	вставлять
пуктавны	назначать
пуктавны	закладывать
пуктыны	вставить
пуктыны	налить
пуктыны	наложить
пуктыны	заложить
пуктыны	выставить
пуктыны	обложить
пуктыны	врезать
пуктыссьыны	прилагаться
пуны	кипеть
пуркйыны	нести
пуркнитны	взвихриться
пуркнитны	обдать
пуркӧситны	вьюжить
пурмӧдны	закупорить
пурмӧдны	затянуть
пустуйтны	пустовать
пустӧшитчыны	опустошиться
пусьыштны	повариться
пусьыштны	поварить
путкыльтны	отвалить
путкыльтчыны	сорваться
путкыльтчыны	кружиться
путкыльтчыны	пасть
путкылявны	кантовать
путкылясьны	валяться
путкылясьны	вываливаться
путкылясьны	переваливаться
пушкыны	пыхтеть
пуӧдны	кипятить
пыдзрасьны	сжиматься
пыдзыртны	выжать
пыдзыртны	кривить
пыдзыртчыны	выжиматься
пыдзыртчыны	сжаться
пыдзыртчыны	иссякнуть
пыдӧсавны	подшить
пызйыны	кропить
пылльысьны	шелушиться
пыригтыны	накрошить
пыркмунны	дрогнуть
пыркмунны	дёрнуться
пыркмунны	тряхнуться
пыркнитлыны	встряхивать
пыркнитны	передёрнуть
пыркнитчыны	сотрястись
пыркӧдны	выжать
пырны	попадать
пырны	засыпаться
пырны	привиться
пырны	задвинуться
пырны	относиться
пырны	засесть
пыртны	завезти
пыртны	заимствовать
пырӧдчыны	присосаться
пырӧдчыны	вникать
пысавлыны	нанизывать
пытайтны	пытать
пытайтны	дознаваться
пышйыны	уйти
пышйӧдны	угнать
пӧвадитчыны	повадиться
пӧдлавны	защемить
пӧдны	утонуть
пӧдтыны	утопить
пӧдтыны	закурить
пӧдтыны	морить
пӧдтыны	погасить
пӧдтысьны	утопиться
пӧжавлыны	перепечь
пӧжавны	пропекать
пӧжсьыны	париться
пӧлнясьны	крениться
пӧлнясьны	переваливаться
пӧлыньтны	стоптать
пӧлыньтчыны	стаптываться
пӧльзуйтчыны	пользоваться
пӧльтны	нагнести
пӧлявны	дуть
пӧлясьны	дуть
пӧрйӧдлыны	лгать
пӧрласьны	опрокидываться
пӧрласьны	разваливаться
пӧрны	претвориться
пӧртмасьны	мерцать
пӧръявлыны	обманывать
пӧръявлыны	лгать
пӧръявны	обмануть
пӧръяссьыны	обмануться
пӧрыньтчыны	опрокинуться
пӧрӧдчыны	прилечь
пӧрӧдчыны	повалиться
пӧсьӧдчыны	пропотеть
пӧткӧдчыны	кормиться
пӧчитайтны	почитать
радейтны	любить
радиофицируйтны	радиофицировать
радлӧдны	радовать
разавны	распылиться
разгысьны	раскинуться
разйысьны	распасться
размунны	развалиться
разьны	расстегнуть
разьны	размотать
разьны	развернуть
разьны	разобрать
разьны	распутать
разьны	открутить
разьсьыны	размотаться
разьсявны	разматываться
разьсявны	развёртываться
разявны	развязывать
разявны	расстёгивать
разявны	расплетать
разявны	разматывать
разявны	развёртывать
разясьны	раскутаться
разӧдны	рассыпать
разӧдны	разнести
разӧдны	раздать
разӧдны	распространить
разӧдны	расселить
разӧдчавны	расползаться
разӧдчыны	расползтись
рамкаавны	оправить
раммыны	утихнуть
расклеитчыны	расклеиться
раснитны	выдернуть
распределитны	распределить
расследуйтны	расследовать
рассуждайтны	рассуждать
рассуждайтны	осуждать
рационализируйтны	рационализировать
ревизируйтны	ревизовать
ревнуйтны	ревновать
резны	мчаться
резьдавны	распускаться
рекмыны	опустеть
рекомендуйтны	рекомендовать
реконструируйтны	реконструировать
ректавны	разгружать
ректавны	выгружать
ректавны	опорожнять
ректавны	обкрадывать
ректыны	разгрузить
ректыны	выгрузить
реорганизуйтны	реорганизовать
реставрируйтны	реставрировать
рискуйтны	рисковать
рифмуйтны	рифмовать
розьӧдлыны	изрешетить
розьӧдны	прогрызть
ротіктыны	трусить
ружтыны	стонать
ружтыны	кряхтеть
ружӧктыны	закряхтеть
рытйысьны	сумерничать
рӧзбойничайтны	разбойничать
рӧзӧритчыны	издержаться
рӧмавны	отливать
рӧммӧдны	покрасить
сакавны	сачить
салютуйтны	салютовать
самавсьыны	наживляться
сапкысьны	вцепиться
сапкысьны	вонзиться
сапожничайтны	сапожничать
сарпыштны	царапнуть
сатшкысьны	щипать
сатшкысьны	льнуть
сверлитны	сверлить
сгинитны	сгинуть
сгӧдитчыны	пригодиться
сгӧдитчыны	подойти
сдавайтны	сдавать
сдайтны	сдать
секретаравны	секретарствовать
серавлыны	смеяться
серласьны	рябить
серпасавны	иллюстрировать
серӧдны	испещрить
серӧссьыны	пестреть
сетавны	выдавать
сетавны	подавать
сетавны	задавать
сетавны	давать
сетавны	сдать
сетлыны	подать
сетны	выдать
сетны	вручить
сетны	представить
сетны	излучать
сетны	наделить
сетны	передать
сетны	сдать
сетсьыны	предоставляться
сетсьыны	выдаваться
сетчывлыны	сдаваться
сетчывлыны	предаваться
сетчывлыны	даваться
сетчыны	податься
сетчыны	даваться
сетчыны	прикинуться
сибусавны	моросить
сибусавны	порошить
сибӧдчыны	подлаживаться
сивӧймыны	сиветь
синитны	синить
синитсьыны	подсиниться
синсьыны	клониться
сины	посвятить
сиптысьны	прикрыться
сирассьыны	просмолиться
скитайтчыны	скитаться
склоняйтчыны	склоняться
сконъясьны	споткнуться
слабмыны	колебаться
славитны	ославить
следитны	следить
снабжайтны	снабжать
снабжайтчыны	снабжаться
собавны	бродить
соблюдайтны	соблюдать
собны	брести
совмещайтны	совмещать
содны	прибывать
содны	спориться
содтыны	усилить
содтыны	углубить
содтыны	умножить
содтыштавны	дополнять
содтыштавны	привирать
соласьны	просолиться
солькмунны	взболтнуться
солькнитны	взболтнуть
сомневайтчыны	сомневаться
соравны	сплавить
сорасьны	сплавиться
сорсьыны	смешать
сорсявны	путаться
сотны	прижечь
сотчыны	зудеть
сотчыны	перегореть
сотчыштны	погореть
спасайтны	спасать
спаситны	спасти
спекулируйтны	спекулировать
специализируйтчыны	специализироваться
спишитны	списать
спормыны	заспорить
спояйтчыны	спаяться
справитны	починить
справитны	ухаживать
справитчыны	справиться
справитчыны	выровняться
спрягайтчыны	спрягаться
стажёравны	стажировать
стартуйтны	стартовать
стерилизуйтны	стерилизовать
стимулируйтны	стимулировать
столуйтчыны	столоваться
столяритны	столярничать
стрӧитсьыны	строиться
стрӧитчыны	отстроиться
стыдитчыны	стыдиться
стынитны	дрыхнуть
стӧчмыны	уточниться
сувтлыны	привстать
сувтлыны	приостановиться
сувтлыны	останавливаться
сувтлыны	касаться
сувтны	предстать
сувтны	млеть
сувтны	застопориться
сувтовкерны	приостановиться
сувтыштлыны	привстать
сувтыштлыны	приостановиться
сувтыштлыны	затронуть
сувтыштны	ступить
сувтыштны	встать
сувтӧдавны	наставить
сувтӧдавны	останавливать
сувтӧдны	остановить
сувтӧдны	заглушить
сувтӧдны	законсервировать
сувтӧдны	застопорить
сувтӧдсьыны	ставиться
судзӧдавны	выписывать
судитны	судить
суетитчыны	суетиться
сукмӧдны	загустить
сулавны	стоить
сулавны	заслуживать
сунавны	нырять
сунласьны	нырять
сунтшикасьны	спотыкаться
сутшкасьны	колоться
сутшкасьны	исколоться
сутшкысьны	вонзиться
сутшкысьны	воткнуться
сутшкысьны	уткнуться
сутшкысьны	приткнуться
сутшкысьны	ткнуться
сутшӧдны	тыкать
сывдыны	развести
сывйыштны	обхватить
сывйыштны	обнять
сывйыштчыны	обняться
сывны	растопиться
сывны	угасать
сывны	убыть
сывъявны	обхватывать
сывъявны	обнимать
сывъясьны	обниматься
сылӧсьтны	просалить
сынавны	огрести
сынны	грести
сыныштны	причесать
сыркӧдны	сотрясать
сырмыны	вибрировать
сырмыны	мерцать
сырмӧдны	поколебать
сысъявны	растранжирить
сьывсьыны	петься
сьӧдъяммыны	привыкнуть
сьӧдӧдны	закоптиться
сьӧдӧдны	окислиться
сьӧласьны	харкать
сьӧлыштны	харкнуть
сьӧлыштны	плевать
сьӧлӧмассьыны	воодушевиться
сэзьдыны	вызвездить
сэпыльтны	высыпать
сювъявны	носиться
сюйны	вставить
сюйны	ввернуть
сюйны	оговорить
сюйны	прибить
сюйны	погрузить
сюйны	провести
сюйыштны	подсунуть
сюйыштны	ввернуть
сюйыштны	заправить
сюйыштны	ткнуть
сюйыштны	заложить
сюркнявны	поджать
сюркнявны	завершить
сюрсасьны	прильнуть
сюртчыны	стремиться
сюсьмӧдны	изощрить
сюсьмӧдчыны	изловчиться
сюявны	ставить
сюявны	сажать
сюявны	наложить
сюявны	заправить
сявгыны	лить
сявкйӧдлыны	брызгать
сявкнитны	присыпать
сявкъявны	шарахаться
сявмунны	шарахнуться
сявмунны	брызнуть
сяльгыны	журчать
сялькӧдчыны	плескаться
сялькӧдчыны	журчать
сяммӧдчыны	изловчиться
сяркнитны	загреметь
сяркӧдчыны	стучать
сяркӧдчыны	брякать
сярӧбтыны	выстрелить
сёйны	впиться
сёльгыны	журчать
сёльмунны	плеснуть
сёльӧдчыны	плескаться
сёрмӧдны	задержать
сёрнитавны	поговаривать
сёрнитавны	переговорить
сёрнитлывлыны	поговаривать
сёрнитлыны	разговаривать
сёрнитны	высказаться
сёртны	гравировать
сімӧдны	ржавить
сітавны	испражняться
сӧвещайтчыны	совещаться
сӧвлыны	ложиться
сӧвмыны	зреть
сӧвмыны	отстояться
сӧвмӧдны	упрочить
сӧвмӧдны	разрабатывать
сӧгласуйтны	координировать
сӧлӧдны	возложить
сӧрны	бредить
сӧткыны	чертыхаться
сӧтны	рубануть
сӧтны	ударить
сӧтыштны	ударить
табанитчыны	упираться
таджикасьны	переваливаться
таджикасьны	растопырить
таджъясьны	упираться
такӧдчыны	убеждать
тальыштны	притоптать
таляссьыны	истоптаться
талясьны	стоптаться
тангысьны	встретиться
тапкыны	хлопнуть
тапкыны	топнуть
тапъявны	топтаться
таргыны	тарахтеть
таркакывны	стучать
таркакывны	греметь
таркӧдны	тарахтеть
тарӧбтыны	застучать
татуируйтны	татуировать
татшкыны	стучать
тачкӧдчыны	стучать
телеграфируйтны	телеграфировать
теньгыны	стонать
терпитсьыны	терпеться
тешитны	смешить
тешкодясьны	оригинальничать
тивзыны	свистеть
тивзыны	визжать
тивкъявны	скользить
тивӧстны	взвизгнуть
тогнитны	тряхнуть
тогнитны	дёрнуть
тойласьны	толкаться
тойласьны	отталкиваться
тойтны	топтаться
тойтны	биться
тойыштны	толкнуть
тойыштны	столкнуть
тойыштны	оттолкнуть
тойыштны	ткнуть
тойыштчыны	оттолкнуться
тольскӧдчыны	плескаться
тольснитны	окунуть
томмӧдны	молодить
томмӧдчыны	молодиться
тоньгӧдчыны	повиснуть
тоньйӧдлыны	болтать
тонькнитны	ударить
топавлыны	кончаться
топнитны	топнуть
топӧдны	крепчать
топӧдчывны	прижаться
топӧдчывны	обняться
топӧдчыны	обняться
топӧдчыштны	потесниться
торгӧдчыны	насторожиться
торйӧдавны	различать
торйӧдавны	отгораживать
торйӧдлыны	группировать
торйӧдсьыны	отводиться
торйӧдчыны	отбиться
торкавны	нарушать
торкасьны	мешаться
торквидзны	торчать
торкнитны	застучать
торксявны	портиться
торпыригавны	распилить
торъявлыны	расслоиться
торъявлыны	распасться
торъявны	разродиться
торъявны	отстать
торъявны	распасться
торӧдны	стучать
тоткӧдчыны	ворчать
тотшнитчыны	чокнуться
тотшсьӧдны	семенить
тотӧдчыны	стучать
тотӧдчыны	рокотать
точйӧдлыны	щёлкать
точкысьны	чокнуться
точнитны	щёлкнуть
точӧдчыны	стучать
трачкӧдчыны	трещать
требуйтны	требовать
тренируйтны	тренировать
тренируйтчыны	тренироваться
тривкнитчыны	дрогнуть
триньгыны	звенеть
тринькерны	прозвенеть
тринькерны	тренькнуть
тринькмунны	зазвонить
троксьӧдны	семенить
троньгысьны	чокнуться
троньӧбтыны	прозвенеть
трудитчыны	трудиться
трӧпитны	утоптать
тубыртны	обложить
тувйыштны	прибить
тувйыштны	навязать
тувйыштны	ударить
тувкйӧдчыны	толкаться
тувкӧдны	подталкивать
тувччавны	ступать
тувччавны	наступать
тувччыны	ступить
тувччыны	наступить
тувъявлыны	прибивать
тувъявны	прибить
тувъявны	навязать
тувъясьны	уставиться
тувъясьны	напроситься
тузьыны	вздуться
туйвежасьны	разминуться
туйдны	наметить
туктавны	тлеть
тунавны	предвещать
тунавны	накликать
тунгыны	окунуть
тунгыны	толкнуть
туны	прибывать
туны	зарасти
тупкавны	закрывать
тупкавны	завешивать
тупкавны	затыкать
тупкавны	заделывать
тупкыны	закрыть
тупкыны	завесить
тупкыны	заделать
тупкысьны	закрыться
тупкысьны	скрыться
туплявны	катать
туплясьны	кататься
туплясьны	валяться
турбылясьны	кувыркаться
турбылясьны	валяться
турликсьыны	растянуться
турыштчыны	нахохлиться
тускассьыны	потускнеть
тускасьны	потускнеть
тусясьны	накрапывать
тутны	перекувырнуться
тутӧдны	перекувырнуть
туясьны	выслеживать
тшапкыны	вонзить
тшолкйӧдлыны	щёлкать
тшолкъявны	щеголять
тшолкӧдны	чеканить
тшолскыны	щёлкать
тшолскӧдлыны	щёлкать
тшолскӧдлыны	цокать
тшукӧдавны	колоть
тшукӧдавны	пригонять
тшукӧдавны	приурочивать
тшукӧдны	пригнать
тшукӧдны	приурочить
тшупны	отрезать
тшыгйӧдчыны	проголодаться
тшынавны	дымиться
тшынасьны	дымиться
тшынйысьны	рыскать
тшӧкмӧдны	участить
тшӧктӧдны	заставить
тшӧкъявны	давиться
тшӧкъявны	осекаться
тшӧкӧлдывайтны	щеголять
тшӧкӧлдывайтны	болтать
тыдовтчыны	показаться
тырмывны	хватать
тырмӧдчыны	успевать
тырны	истечь
тырны	зарасти
тырны	выполняться
тырсьӧдны	опылить
тыртавны	наполнять
тыртавны	доливать
тыртавны	заваливать
тыртавны	выполнять
тыртавны	начинять
тыртны	выполнить
тыртны	отжить
тыртчыны	зарыться
тыртыштны	запорошить
тыртӧмавны	пустовать
тыртӧммыны	опустеть
тышкасьны	драться
тышкасьны	бороться
тышкасявны	передраться
тэрмӧдны	торопить
тэрыбмӧдны	ускорить
тэтшкыны	чуфыкать
тювйӧдлыны	метать
тювкъявны	шмыгать
тювкъявны	нырять
тювӧдны	побежать
тюльскысьлыны	окунуться
тюргыны	звенеть
тюргыны	кудахтать
тюрзыны	свистеть
тюрзыны	верещать
тюрзыны	стрекотать
тюрйӧдлыны	катать
тюрны	течь
тюрӧбтыны	зазвонить
тюрӧстны	свистнуть
тюрӧстны	пискнуть
тявгыны	тявкать
тявзыны	тявкать
тягайтчыны	тягаться
тяльскӧдчыны	шушукаться
тяльскӧдчыны	сплетничать
тяльснитны	ляпнуть
тяльснитны	выболтать
тяпкӧдны	прошлёпать
тяпкӧдчыны	чмокать
тяпнитны	чмокнуть
тяпъявны	шлёпать
тёльскӧдны	плескать
тёльӧдчыны	звенеть
тёпкыны	капать
тёпкыштны	капнуть
тёпкыштны	покапать
тёпкӧдчыны	звенеть
тівкйӧдлыны	толкать
тільгыны	звенеть
тільскыны	звенеть
тінгыртны	семенить
тіньгыртны	семенить
тіравны	мерцать
тірзьыны	колебаться
тіркнитны	прибежать
тірмунлыны	вздрагивать
тірӧдчыны	дрыгать
тӧбсьыны	набиться
тӧвзьӧдны	обесцветить
тӧдлыны	знать
тӧдлыны	заметить
тӧдмавны	опознать
тӧдмасявны	перезнакомиться
тӧдны	знать
тӧдчӧдны	обозначить
тӧдчӧдны	заострить
тӧждысьны	дорожить
тӧлксьӧдны	умудрить
тӧлкуйтны	разъяснить
тӧлкуйтыштны	порассуждать
тӧлӧдны	вялить
тӧмитчыны	застояться
тӧрскысьны	сломаться
убедитчыны	убедиться
убеждайтчыны	убеждаться
увгыны	шуметь
увгысьны	подняться
увкйӧдлыны	аукать
увкйӧдлыны	бухать
увкнитны	аукнуть
увкнитны	бухнуть
увкнитны	ворваться
увтны	лаять
увтчыны	залаять
увтыртчыны	унижаться
увтыштны	тявкнуть
увтыштны	обозвать
уджавны	работать
уджавны	действовать
уджӧдны	обкатать
уджӧдны	обслуживать
удзавны	опоздать
удзӧдчыны	обделять
удзӧдчыны	объедать
ужнайтсьыны	отужинать
узьлыны	спать
узьлыны	ночевать
узьлыны	сожительствовать
узьмӧдчыны	заночевать
узьны	спать
уйны	бежать
укйӧдлыны	ухать
укнитны	ухнуть
укнитны	бухнуть
укшальмӧдны	отяжелить
укшальмӧдны	обессилить
уллюнйӧссьыны	скоромиться
ульдавны	подтаивать
унаавны	умножить
унмовськӧдны	усыплять
унӧрӧвитны	подчиняться
упакуйтны	упаковать
упкысьны	провалиться
упкӧбтыны	обдать
ургыны	урчать
уркйӧдлыны	продувать
урсавны	накликать
урӧсмыны	обезобразиться
усмиритчыны	удовлетвориться
уставитны	наставлять
уставитны	наряжать
устроитчыны	устроиться
уськӧдны	сбросить
уськӧдны	ронять
уськӧдны	разорить
уськӧдчыны	выскочить
усьны	впадать
усьны	потерять
утюжитны	бить
участвуйтны	участвовать
учителявны	учительствовать
уявны	плавать
ходатайствуйтны	ходатайствовать
чабыртны	схватить
чажмунны	хрустнуть
чажӧбтыны	дзинькнуть
чаклейтны	тлеть
чамгыны	ударить
чангыльтны	отогнуть
чапасьны	царапаться
чарснитны	чиркнуть
чарснитны	царапнуть
чатӧрмунны	откинуться
чашйыны	исцарапать
чашйысьны	исцарапаться
чашкавны	раздвинуться
чашнитны	царапнуть
чегны	разбить
чегсьыны	надрываться
чегъявны	подрезать
чегъявны	надрываться
чегъясьны	надрываться
чезыртны	морщить
чеканитны	чеканить
чепльӧдлыны	щемить
чеплясьны	щипаться
чепӧльтны	отщипнуть
чердлыны	вздрагивать
чередуйтчыны	чередоваться
чертитавны	перечертить
чертитны	начертить
черӧбзьыны	шелохнуться
чеченитны	дорожить
чеччавны	выпрыгивать
чеччавны	перескакивать
чеччыштны	перевалить
чибӧасьны	ожеребиться
чиганитчыны	издеваться
чидлыны	радоваться
чижикасьны	плясать
чикрасьны	жмуриться
чикрӧдлыны	жмурить
чикыльтчыны	свернуться
чилльыны	собирать
чилснитавны	попивать
чинтавны	распилить
чинтавсьыны	распиливаться
чинтӧдчыны	сокращаться
чипӧстны	свистнуть
чипӧстны	пикнуть
чирзасьны	гримасничать
чирйыны	лущить
чиркнитлывлыны	чиркать
чиркнитны	чиркнуть
чирсны	стереть
чирссьыны	размочалиться
чискыны	сопеть
читкыльтны	загнуть
чожмыны	ускориться
чожмӧдны	ускорить
чокнитчыны	чокнуться
чольгыны	журчать
чольгыны	струиться
чольӧбтыны	отлить
чорзьыны	черстветь
чорзьыны	ожесточиться
чорзьӧдны	ожесточить
чорпавны	искривиться
чотавны	стреножить
чотликасьны	прихрамывать
чотны	зевать
чошкӧдчыны	ощетиниться
чошкӧдчыны	раскрыться
чувъявны	шнырять
чужавны	народиться
чужтавны	народить
чуймавны	удивляться
чукйӧдны	переполнить
чуклясьны	кривляться
чукрӧдлыны	моргать
чуксасьны	перекликаться
чуктыны	трогаться
чуктӧдны	выделить
чукъявны	возвышаться
чукъяммыны	переполниться
чукыртны	искривить
чукыштчыны	припухнуть
чукӧртны	трелевать
чукӧртчывлыны	собираться
чукӧстны	разбудить
чулькнитны	отлить
чургӧдны	протянуть
чурйӧдлыны	протягивать
чусмӧдны	застирать
чутавны	запятнать
чуткасьны	колоться
чушйӧдлыны	кусаться
чушкыльтчыны	вспылить
чушкыны	нюхать
чушкыны	шипеть
чушмунны	вспылить
чушмунны	прошаркать
чушнитны	шаркнуть
чӧвтавны	закидывать
чӧвтавны	снимать
чӧвтавны	набросать
чӧвтлыны	закинуть
чӧртуасьны	чертыхаться
чӧскыдасьны	лакомиться
чӧсмасьны	наслаждаться
шавгыны	рассеяться
шавйӧдлыны	развевать
шавкнитны	рассыпать
шавкъявны	носиться
шавъявны	рассыпаться
шаньмыны	похорошеть
шаньмыны	успокоиться
шапсьыны	пениться
шапъявны	шуршать
шаргыны	дребезжать
шаркйыны	тереть
шаркнитны	шаркнуть
шаркъявны	жужжать
шаркӧдны	шаркать
шарсйӧдлыны	чиркать
шарӧбтыны	брызнуть
шарӧдчыны	стучать
шатлӧдлыны	расшатать
шашкыны	шепелявить
швачвидзны	торчать
швачкакывны	трещать
швачкакывны	стучать
швичйӧдлыны	свистеть
швичӧдны	махать
швульсъявны	хлюпать
швульсъявны	скользить
швучкыны	завывать
шевгыны	распахнуть
шевгысьны	раскрыться
шевкнитчыны	раскинуться
шевкъявны	парить
шевъявны	парить
шедавны	попадаться
шедны	достаться
шедӧдавны	получать
шедӧдны	получить
шенасьны	отмахиваться
шенасьны	замахиваться
шенасьны	жестикулировать
шеныштчыны	раскинуться
шеныштчыны	взметнуться
шердйысьны	трястись
шковгыны	греметь
шковгыны	трещать
шкоргыны	храпеть
шкоркйӧдлыны	всхрапывать
шкорӧдчыны	шипеть
шкуркнитны	переметнуть
шлапкыны	плюхнуть
шлапкыны	шлёпать
шлачкысьны	хлопнуться
шлачкӧдны	стегать
шлачнитны	щёлкнуть
шливдыны	скользить
шливкнитны	сползти
шливкнитны	расчесать
шливскыны	скользить
шлопвидзны	торчать
шлопкысьны	лопнуть
шлопкӧдчыны	шелестеть
шлопкӧдчыны	хлопать
шлопӧдны	шлёпать
шлочкыны	щёлкать
шлочмунны	хрустнуть
шлочӧдны	хлопать
шлочӧдны	щёлкать
шлювкйыны	скользить
шлявавны	развалиться
шлячкӧдчыны	хлестаться
шлячкӧдчыны	трещать
шлячнитны	хлопнуть
шлёндайтны	шлёндать
шлёчмунны	шлёпнуться
шлёчӧдны	шлёпать
шматйӧдлыны	шмякать
шмотӧдчыны	гнусавить
шняритны	жрать
шняритны	дрыхнуть
шобны	обыскать
шоймыны	омертветь
шольгӧммыны	крупнеть
шолькйысьны	плескаться
шольны	разбиться
шомасьны	обуглиться
шоммӧдны	кислить
шомсявны	обуглиться
шочмӧдны	замедлить
шпоракывны	трещать
шпорӧдчыны	сопеть
шпуткыны	дуть
шпынйысьны	лохматиться
штампуйтны	штамповать
штрапуйтны	штрафовать
шувгыны	шуршать
шудтӧммӧдны	обездолить
шудӧдны	осчастливить
шулявны	распластать
шумитны	шуметь
шуммӧдны	распарить
шундыртчыны	шевелиться
шупӧдны	вялить
шургыны	журчать
шургыны	жужжать
шурӧбтыны	пронестись
шутитны	шутить
шутьӧктыны	свистнуть
шутьӧктыны	взвыть
шыбитны	перебросить
шыбитчыны	откинуться
шыблавны	разметать
шыблавны	извергать
шыбласьны	метаться
шывылпатеруйтны	уволить
шыльдыны	скользить
шылькйӧдлыны	гладить
шылькнитчыны	раскинуться
шылявны	пополнеть
шыннявны	ехидничать
шыннявны	красться
шыпасавны	написать
шырны	косить
шырыштны	постричь
шышкасьны	воровать
шыӧдны	озвучить
шыӧдчыны	обратиться
шӧпеявны	бредить
шӧпкыны	бормотать
шӧпкӧдчыны	бормотать
шӧпъявны	бредить
шӧравлыны	накроить
шӧрыштны	отрезать
шӧрыштны	разрезать
шӧрыштны	хлестнуть
шӧтны	засыпать
щальдавны	раскалываться
щальдавны	растрескиваться
щальдыны	расколоться
щӧгӧляйтны	щеголять
щӧлкнитны	щёлкнуть
ыджыдавны	преобладать
ыджыдавны	предводительствовать
ыджыдджыкавны	старшинствовать
ызбыльтны	вывалить
ызвидзны	расстилаться
ызгысявны	бултыхаться
ызмунны	вспыхнуть
ызъявны	брызгать
ыкайтны	кряхтеть
ыкӧстны	застонать
ылавны	увлечься
ылькнитны	повалить
ылькъявны	валить
ылькъявны	врываться
ылӧдлыны	отвлекать
ылӧдлыны	заманивать
ылӧдны	выманить
ымравны	пахнуть
ыпнитлыны	обдавать
ыпнитны	обдать
ыркалыштны	успокоиться
ыркӧдны	похолодать
ырмасьны	егозить
ырньӧдны	окрасить
ырнявны	окраситься
ырсмунны	вздрогнуть
ырсъявны	дёргаться
ыршасьны	замахиваться
ырыштчыны	замахнуться
ырыштчыны	намереваться
ыстывны	засылать
ыткӧбтыны	и
ышавны	воодушевиться
ышлолавны	вздыхать
ыштӧдчыны	настроиться
эвакуируйтны	эвакуировать
эвакуируйтчыны	эвакуироваться
эжны	покрыть
эзысясьны	серебриться
экзаменуйтны	экзаменовать
экспортируйтны	экспортировать
электрифицируйтны	электрифицировать
эргӧдлыны	скалить
эрдӧдавны	обнажать
эрдӧдны	обнажить
эрдӧдны	раскрыть
эрдӧдчыны	обнажиться
эршасьны	замахиваться
эскыссьыны	вериться
этшсьӧдны	обуздать
эшкӧдны	раскрыть
эштӧдчыны	уложиться
югвидзны	светиться
югдыны	осветиться
югдӧдны	выяснить
югзьыны	светиться
юкассьыны	расщепляться
юковтны	прорезать
юковтчыны	раздвинуться
юксьыны	делиться
юксьыны	поделиться
юксьыны	разводиться
юммыны	солодеть
юны	пропить
юравны	копнить
юравны	председательствовать
юравны	греметь
юрбитны	молиться
юркнитны	шмыгнуть
юрнимавны	озаглавить
янавны	устыдиться
янсавлыны	разлучаться
янсавлыны	отстать
яритны	горячиться
яровизируйтны	яровизировать
ятшкыны	жевать
ёвкнитӧдны	передёрнуть
ёгдыны	мусорить
ёгӧсьтчыны	сорить
ёкмыльтны	свернуть
ёкмылявны	комкать
ёкыштны	уставить
ёкыштчыны	уставиться
ёкыштчыны	замахнуться
ёкыштчыны	ощетиниться
ёрсьыны	проклинать
ёсьмӧдны	напрячь
ёсьтысьны	направляться
ӧбидитны	обидеть
ӧбидитчыны	обидеться
ӧввӧдны	качать
ӧвтчыны	отмахиваться
ӧвтыштны	повеять
ӧвтыштны	смахнуть
ӧвтыштчыны	обмахнуться
ӧвтыштчыны	отказаться
ӧградитчыны	огородиться
ӧддзыны	разойтись
ӧддзыны	усиливаться
ӧддзӧдны	раскачивать
ӧддзӧдчыны	разбежаться
ӧддзӧдчыны	усилиться
ӧжигайтчыны	закалиться
ӧзйыны	загореться
ӧзйыны	гореть
ӧзтавны	зажигать
ӧзтавны	разжигать
ӧзтавны	поджигать
ӧзъявны	гореть
ӧзъявны	загораться
ӧктысьны	подбирать
ӧлавны	веять
ӧловтны	забросить
ӧловтны	сбросить
ӧлӧдны	уговорить
ӧтвесьтӧдны	уравновесить
ӧтвечайтны	отвечать
ӧтвыйӧдны	сровнять
ӧтдортчыны	устраниться
ӧтикывъясьны	согласиться
ӧткодясьны	сравниться
ӧтлаавны	объединить
ӧтлаавны	смешать
ӧтлаасьны	объединиться
ӧтлаасьны	смешаться
ӧтлаасьны	совпасть
ӧтлаасьны	срастись
ӧтрӧвнясьны	сровняться
ӧтрӧвнӧавны	выровнять
ӧтсорасьны	смешаться
ӧтувтны	обобществить
ӧтьведайтны	подсматривать
ӧшавны	свисать
ӧшйыны	лечь
ӧшӧдавны	вешать
ӧшӧдавны	вывешивать
ӧшӧдавны	свешивать
ӧшӧдны	повесить
ӧшӧдны	вывесить
ӧшӧдны	свесить
