абонементный	абонемента
абсурдный	лӧсявтӧм
абхазский	абхаз
авансовый	аванс
авиамодельный	авиамодель
авральный	тэрмӧдлан
австралийский	австралияса
австрийский	австрияса
автобусный	автобус
автогенный	
автоматический	автоматическӧй
автомобильный	автомобиль
авторский	автор
автотранспортный	автотранспорт
автохтонный	вужвойтыра
агатовый	агат
агрономический	агрономия
агропромышленный	агропромышленнӧй
агротехнический	агротехническӧй
адаптированный	кокньӧдӧм
аджарский	аджар
административный	администрация
адмиральский	адмирал
адъютантский	адъютант
адыгейский	адыгей
азербайджанский	азербайджанса
азиатский	азияса
азотистый	азота
акварельный	акварель
акробатический	акробатика
актовый	акт
актёрский	ворсан
албанский	албан
алгебраический	алгебра
алгебраический	алгебраса
алебастровый	вальді
аллегорический	аллегория
аллергический	аллергия
алмазный	алмаз
алойный	алоэ
алфавитный	анбур
алюминиевый	алюминий
алюминиевый	лемень
амбулаторный	бурдӧдчанінса
американский	америкаса
аммиачный	аммиак
ампутированный	вундӧм
амурный	радейтчан
аналитический	аналитическӧй
анархистский	анархист
анатомический	анатомия
английский	англияса
ангорский	ангораса
анимистический	ловзьӧдан
анкетный	анкета
аномальный	нелючки
антипатичный	мустӧм
антихудожественный	художествотӧм
антропологический	антропология
аптечный	аптека
арабский	араб
арбитражный	арбитр
арбитражный	венъюкан
арбузный	арбуз
арестованный	арестуйтӧм
аристократический	аристократ
арифметический	арифметика
арктический	арктикаса
арматурный	арматура
армейский	армия
армейский	армияса
армянский	армян
армячный	сукман
артериальный	артерияса
артиллерийский	артиллерия
археологический	археология
архивный	архивса
архитектурный	стрӧйба
асбестовый	асбест
ассистентский	ассистент
астрономический	астрономия
атакованный	атакуйтӧм
атлетический	атлетическӧй
атомный	атом
атомный	атомнӧй
аттестационный	донъялан
аттический	аттикаса
аудиторский	ревизия
аульный	аулса
аутогенный	асызйӧга
афганский	афган
афишный	афиша
афишный	юӧртан
африканский	африкаса
аховый	
аэродромный	аэродром
багажный	кӧлуй
багорный	багыр
базисный	подув
байковый	байка
байковый	байкӧвӧй
бакалейный	бакалея
баклажанный	баклажан
бактериологический	бактериология
балаганный	балаганса
балалаечный	балалайка
балкарский	балкар
балконный	балконса
балластный	балласт
баллистический	баллистическӧй
баловной	
баловной	
бамбуковый	бамбук
банановый	банан
бандитский	бандит
банкетный	банкет
банкирский	банкир
банный	пывсян
барабанный	барабан
барбарисовый	барбарис
барельефный	мыгӧра
барочный	барокко
баррикадный	баррикадаяса
барский	барин
барсовый	барс
барщинный	барщина
баскетбольный	баскетбол
басовый	бас
батистовый	батист
батрацкий	батрак
башкирский	башкыр
башмачный	башмак
баянный	баян
бедненький	коньӧранӧй
бедняцкий	гӧль
бедренный	лядьвей
безбилетный	билеттӧм
безбородый	тоштӧм
безбровый	синкымтӧм
безверхий	йывтӧм
безвизовый	визатӧм
безвинный	мыжтӧм
безвоздушный	сынӧдтӧм
безвольный	небыд
безгрешный	гректӧм
безденежный	сьӧмтӧм
бездефектный	изъянтӧм
бездефицитный	тырмана
бездорожный	туйтӧм
бездоходный	чӧжӧстӧм
беззвёздный	кодзувтӧм
безземельный	мутӧм
безлошадный	вӧвтӧм
безлунный	тӧлысьтӧм
безлюдный	йӧзтӧм
безмоторный	мотортӧм
безоружный	оружьетӧм
безостый	йикитӧм
безотходный	колястӧм
безрельсовый	рельстӧм
безухий	пельтӧм
безучастный	веськодь
безыдейный	идеятӧм
безымянный	нимтӧм
безынициативный	водзмӧстчытӧм
беллетристический	беллетристика
беловой	лякпастӧм
белогвардейский	белогвардейскӧй
белый	
бельгийский	бельгияса
бельевой	белльӧ
бельевой	паськӧм
бензиновый	бензин
бережливый	
бережёный	
берестяной	сюмӧд
бесквартирный	патератӧм
бесклассовый	классъястӧм
бескостный	лытӧм
бескризисный	кризистӧм
беспалый	чуньтӧм
беспаспортный	паспорттӧм
бесполый	рӧдтӧм
беспородный	йывман
беспримесный	сорлавтӧм
беспристрастный	веськыд
беспроволочный	проводтӧм
бессолевой	совтӧм
бессолнечный	шондітӧм
бесструктурный	тэчастӧм
бесструнный	везтӧм
бессюжетный	сюрӧстӧм
бестарифный	тарифтӧм
бесфамильный	овтӧм
бесхвостый	бӧжтӧм
бетонированный	бетоналӧм
бетонный	бетон
бетонный	бетона
библейский	библияса
библиографический	библиография
библиотечный	библиотека
билетный	билет
биографический	олантуя
биологический	биология
бисквитный	бисквит
благочестивый	еннога
благочинный	
благочинный	
бланковый	бланокса
блошиный	пытш
блудливый	
блудный	шляйтчысь
богатый	
богомольный	еннога
боевой	
бокситовый	боксит
болотный	нюрса
большевистский	большевик
бомбардировочный	бомбардируйтан
борный	борнӧй
босой	кӧмтӧм
ботанический	ботаника
ботанический	ботаническӧй
бочечный	бӧчка
бочечный	бӧчкаса
бражный	сур
братский	вок
бревенчатый	кер
брезентовый	брезент
бригадный	бригадаса
бриллиантовый	бриллиант
бриллиантовый	бриллианта
британский	британияса
бритвенный	бритчан
бритый	бритӧм
бродильный	шузьӧдчан
бродяжнический	зимогоралан
брокерский	сёрнитчӧдан
бронзовый	бронза
брусковый	бруска
брусничный	пув
брусничный	пувъя
брючный	гач
брючный	гача
брюшной	кынӧм
бубновый	бубин
букварный	шыпаскуд
буковый	бук
буксирный	кыскан
буланый	буланӧй
буржуазный	буржуазия
буржуйский	буржуй
бурлацкий	бурлак
бурятский	бурят
бухгалтерский	бухгалтерия
бюджетный	бюджет
бюджетный	бюджетса
бюрократический	бюрократ
бязевый	бязь
вагонный	вагон
вазелиновый	вазелин
вазелиновый	вазелина
валяльный	гындысян
варочный	пусян
варёный	пуӧм
вахтенный	вахтаа
вахтенный	
ваятельный	сёртан
ввозный	ваян
вдевальный	пысалан
вдувной	пӧльтан
вдумчивый	вежӧра
вексельный	вексель
вексельный	вексельса
велосипедный	велосипед
венерический	
венский	венскӧй
вепсский	вепс
вербный	берба
вербованный	медалӧм
вербовочный	медалан
вересковый	тусяпу
вересковый	тусяпуа
верстовой	верста
вертикальный	сувтса
вертлужный	дзулля
вертлявый	
верёвочный	гез
веснушчатый	беринӧсь
ветряной	тӧв
ветчинный	ветчина
вещевой	кӧлуй
вещественный	кӧлуй
веяный	тӧлӧдӧм
взводный	
взводный	взводнӧй
взрослый	
взрывной	грымӧб
вибрационный	сырман
вигоневый	вигонь
винный	вина
виновный	
винтовочный	винтовка
вирусный	вируса
височный	кӧсича
витаминный	витамина
включённый	сюйӧм
вневедомственный	ведомствоӧтдорса
внеклассный	гортса
внеконкурсный	конкурстӧг
внутривенный	венапытшкӧсса
внутригосударственный	канмупытшса
вогульский	йӧгра
водный	ва
водный	вавывса
водоупорный	
водочный	вина
военный	
военный	военнӧй
воздержанный	видзчысьысь
возлюбленный	
воинский	воин
воинский	военнӧй
войсковой	войска
вокальный	сьылан
вокзальный	вокзал
волейбольный	волейбол
волостной	вӧлӧсьт
волостной	вӧлӧсьтса
волосяной	си
воплощённый	
вопросительный	
вороватый	
воронёный	сьӧдӧдӧм
восклицательный	горӧдан
восковой	воска
вощёный	сиськалӧм
впускной	лэдзан
врачебный	врач
врачебный	бурдӧдчан
врубовый	
вспаханный	гӧрӧм
встречный	
всхолмлённый	мылькъя
всякий	
всякий	
всякий	
втолкнутый	йӧткыштӧм
вторничный	воторникся
второй	
второй	
второразрядный	шӧркоддьӧм
вшивый	тойӧсь
въедливый	
въездной	пыран
выборный	
выбраковочный	бракуйтан
выводной	петкӧдан
выворотный	гугӧдан
выдвижной	кыскысян
выжидаемый	виччысяна
выкупной	вештысян
вылитый	
вылощенный	
вылощенный	волялан
вымский	емватас
выпечной	пӧжалӧм
вырезной	серӧдлӧм
вырытый	кодйӧм
высевной	кӧдзан
выселенный	вӧтлӧм
высеченный	сизьдӧм
высокооктановый	ӧдъя
высокопродуктивный	бур
выставочный	выставка
выставочный	выставкавывса
вытертый	чышкӧм
вытисненный	личкалӧм
вытопленный	сывдӧм
вытопной	сывдан
вытравной	травитан
вытяжной	кыскан
выученный	велӧдӧм
выходной	
выходной	шойччысь
выхоленный	
вышибленный	жугӧдӧм
вышивальный	вышивайтчан
вышивной	вышивайтӧм
вышивочный	вышивайтан
вышитый	вышивайтӧм
вьюжный	турӧб
вязаный	кыӧм
вязовый	сирпу
вязовый	сирпуа
габардиновый	габардин
гагатовый	гагат
гагаузский	гагауз
гадальный	гадайтчан
гаечный	гайка
газетный	газет
газетный	газетса
галечный	галяизъя
гаражный	гараж
гардеробный	гардероб
гармонический	
гармонный	гудӧк
гарнизонный	гарнизон
гарнизонный	гарнизонса
гарный	сотан
гарусный	гарус
гастрольный	гастрольса
гастрономический	гастрономия
генеалогический	орд
генеральский	генерал
генетический	вужвуджӧда
географический	география
геодезический	геодезия
геологический	геология
германский	герман
герметический	йиджтӧм
геройский	повтӧм
гиблый	
гимнастический	гимнастика
гимнастический	турисювтчан
гинекологический	гинекология
гипсовый	кориз
гипюровый	гипюр
гипюровый	гипюра
главный	
главный	медтӧдчанатор
глагольный	кадакыв
гладильный	гладитчан
глаженый	гладитӧм
глазастый	
глинистый	сёйӧд
глиняный	сёй
глицериновый	глицерин
глицериновый	глицерина
глотательный	ньылалан
гнездовой	позъя
гнутый	
гоголиный	сювчӧж
годовалый	арӧса
голландский	голландса
головастый	
головоногий	юркока
голословный	подулавтӧм
голосовой	гӧлӧс
голубичный	чӧдлач
голубой	кельыдлӧз
гольдский	гольд
горелый	
горловой	горш
горновой	
горнозаводский	горнозаводскӧй
горностаевый	сьӧдбӧж
городовой	
городовой	
городовой	полицияса
городской	
горский	гӧравывса
горчичный	горчица
горький	
госпитальный	госпитальса
гравитационный	гравитация
гражданский	гражданин
гражданственный	гражданин
грамматический	грамматика
граммофонный	граммофон
гранатный	граната
гранитный	гранит
гранулированный	шольгӧмтӧм
графлёный	визьйӧдлӧм
гребенной	сынана
гребнистый	сорса
гречишный	гречуга
грешный	грека
грибковый	тшака
грибной	тшака
гривистый	
гримёрный	
гриппозный	грипп
громовой	гыма
грошовый	
грудинный	морӧспаньса
гружёный	сӧвтӧм
грузинский	грузин
грузовой	грузӧвӧй
губернаторский	губернатор
губернский	губернияса
гулевой	
гуманистический	гуманизм
гуманитарный	гуманитарнӧй
гусарский	гусар
гусельный	гусли
гусиный	дзодзӧг
гуцульский	гуцул
давленый	
дагестанский	дагестанса
дальнозоркий	
дамский	нывбаба
данный	
дарственный	
дательный	
датированный	кадпаса
дачный	дачаса
дверной	ӧдзӧс
двойной	
дворовый	
дворцовый	дворечса
дворянский	дворяна
двоюродный	воча
двуликий	
двуликий	
девонский	девон
девятикратный	ӧкмысысь
дежурный	
декадентский	декадент
делегатский	делегат
деликатесный	чӧскыд
деляческий	кӧнӧбой
демагогический	демагог
демографический	демография
демонстрационный	петкӧдлан
деморализованный	иприл.
дентальный	пиньбердса
деповский	депо
деповский	депоса
депутатский	депутат
деревянный	пуа
дерматиновый	дерматин
дерновый	эжа
дерновый	эжаа
десантный	десант
детский	
дефектный	тшыкӧм
джазовый	джаз
диалектический	диалектика
диалектный	сёрнисикаса
дизентерийный	мыт
диктаторский	диктатор
дипломированный	диплома
директивный	тшӧктана
директорский	директор
дирижёрский	дирижёр
дирижёрский	дирижируйтан
дисгармоничный	лӧсявтӧм
дисковый	гӧгыля
дискотечный	дискотекаса
диспетчерский	
дистиллированный	весалӧм
длинноватый	кузькодь
длинный	кузь
добавочный	содтӧд
доблестный	
доверенный	
договорный	сёрнитчан
дождливый	зэра
дозорный	
дозорный	видзӧдысь
доильный	лысьтысян
дойный	лысьтан
доказательный	эскӧдан
доклассовый	классӧдзса
доковый	докса
докторский	бурдӧдчысьӧн
долговой	уджйӧза
должный	
доломитовый	доломит
доменный	домна
домовитый	идӧра
допотопный	
допризывный	призывводзвывса
допросный	юасян
доцентский	доцент
доцентский	доцентлӧн
дошкольный	школаӧдзса
дощатый	пӧвъя
драконический	гундыр
драматургический	драматургия
драповый	драп
древесный	пу
дресвяный	дзимбыра
дровяной	пес
дрожжевой	рокӧс
дрожжевой	рокӧса
другой	
другой	мӧд
другой	
другой	мӧдтор
дубильный	дубитчан
дубовый	тупуа
дымовой	тшын
дырчатый	розьӧсь
дыхательный	лолалан
дятловый	сизь
евангелический	евангелльӧ
евангелический	бурвисьталан
евразийский	евразияса
еврейский	еврей
европейский	европаса
египетский	египетса
единовременный	ӧтпырся
единогласный	ӧтсӧгласа
ежевичный	ежевика
ежовый	ёж
ездовой	
езженый	
енотовый	енот
ершистый	
ершовый	йӧрш
жалоносный	чушкысь
жалостливый	
жареный	пражитӧм
жатвенный	вундан
жвачный	
желаемый	
желанный	
желательный	колан
желейный	лемӧга
желобчатый	воргаа
желудочный	кынӧм
жердевой	потша
жерновой	изки
жестяной	жӧч
жжёный	сотӧм
живой	
живой	олӧ
жилищный	олан
жилой	олан
жреческий	тун
журавлиный	тури
жёсткий	иперен.
забавный	тешкодь
забастовочный	бастуйтан
забивной	тувъялан
забитый	
забористый	
завлекательный	босьтчӧдан
заводной	заведитан
заводской	
завозный	вайӧм
загорелый	гожъялӧм
загородный	карсайса
заготовленный	вӧчӧм
заготовочный	вӧчан
заграничный	суйӧрсайса
загребной	
загребной	сынысь
загрузочный	сӧвтан
задавленный	
задолженный	уджйӧзалӧм
задорный	
задёрганный	
зажимный	топӧдан
зазвонистый	
зазубренный	
закалённый	иприл.
заключительный	бӧръя
законченный	
законченный	
закрытый	
закрытый	
закрытый	
закусочный	нуръясян
залежалый	
заливочный	кисьтан
зализанный	
замаскированный	
замороженный	
заморённый	
замочный	томан
замшевый	няр
занозистый	
занятый	
заозёрный	тысайса
заострённый	
заострённый	ёсь
запасный	содтӧд
запечный	пачсайса
запоночный	запанкиа
запретный	позьтӧм
запуганный	
запустелый	
запутанный	
запутанный	дзуг
запутанный	
заражённый	пӧрӧса
заразительный	
заревой	кыа
заржавленный	сімӧм
зародышевый	пытшпи
зарубежный	суйӧрсайса
засадный	кыйӧдчан
заселённый	
заскорузлый	
заслуженный	иприл.
заспанный	унзіль
застрахованный	страхуйтӧм
заступнический	доръян
затерянный	
заумный	гӧгӧрвотӧм
захирелый	
зачарованный	иприл.
зачётный	артӧса
зашейный	сьылісайса
защитительный	дорйысян(а)
защёчный	банбоксайса
звонковый	звӧнок
зевательный	очсалан
земельный	му
земноводный	
земной	му
земский	
зерновой	
злаковый	
злободневный	медколан(а)
злокачественный	лёк
злонамеренный	
змеистый	чукыльӧсь
знаковый	паса
знакомый	
знакомый	тӧдса
знакомый	
зодиакальный	зодиак
золотой	
золотушный	зӧлӧтукаа
зональный	зона
зональный	зонаса
зонтичный	
зоологический	зоология
зоотехнический	зоотехника
зрелищный	видзӧдан
зубастый	
зубатый	пиня
зубной	пинь
зубовой	пиня
игольный	ем
игорный	ворсан
игральный	ворсан
игровой	ворсан
идеалистический	идеалистическӧй
идентификационный	ӧткодялан
идеографический	гижӧдпаса
идеологический	идеология
идеологический	ловнуӧдан
идиотский	
иерархический	иерархия
избитый	иприл.
избранный	
избранный	
избранный	медбуръяс
избяной	керка
известковый	кориза
известный	
известняковый	кориз
извинительный	
извитый	
извращённый	
изжёванный	
изжёванный	
излечимый	бурдан
изломанный	иприл.
изменчивый	вежласян(а)
измызганный	
измызганный	
изнаночный	гугладор
изношенный	
изобразительный	
изодранный	
изолировочный	эжсян
изоляционный	эжсян
изорванный	
изорванный	розя
изъезженный	
изящный	
иконный	ӧбраз
икристый	пӧкъя
икряной	пӧкъя
илистый	нюйта
ильмовый	сирпуа
именинный	нимлунъя
именной	нима
императивный	тшӧктан(а)
империалистический	империалистическӧй
имперский	империяса
импульсивный	
инвалидный	инвалид
инвалидный	вермытӧм
ингаляционный	апалан
ингушский	ингуш
индейский	индееч
индийский	индияса
индикаторный	петкӧдчан
индоевропейский	индаевропаса
индонезийский	индонезияса
индустриальный	индустриальнӧй
инженерный	инженер
инициаторский	водзмӧстчан
инкрустированный	серӧдӧм
иной	
институтский	институтса
инструментальный	
интерпретаторский	гӧгӧрвоӧдан
информационный	юӧр
ипотечный	ипотекаса
иракский	иракса
ирландский	ирландса
искомый	
искомый	корсянтор
искромётный	
исландский	исландса
испанский	испанияса
исповедуемый	висьтасьысь
испольный	шӧриа
испорченный	иприл.
истасканный	
истовый	
истребительный	бырӧдан
истрёпанный	иприл.
июльский	сора
июльский	июльса
июньский	июньса
йодистый	йода
йодный	йод
йодный	йода
йоркширский	йоркширса
кабардинский	кабардаса
каверзный	
кавказский	кавказса
кадильный	кадилӧ
каждый	
казанский	казаньса
казарменный	казармаса
казахский	казах
казацкий	казак
казеиновый	казеин
казначейский	казначей
казначейский	казначейскӧй
казённый	казеннӧй
какой	
калийный	калий
калиновый	жовпу
калмыцкий	калмык
калорийный	окта
калориферный	калорифер
кальциевый	кальций
каменноугольный	изшом
каменный	изъя
камфарный	камфара
камышовый	камыша
канализационный	канализация
кандидатский	кандидат
каникулярный	каникул
канифольный	канифоль
каннибальский	
канцелярский	канцелярияса
капиталистический	капиталистическӧй
капитанский	капитан
капроновый	капрон
капсюльный	пистона
караванный	караван
каракалпакский	каракалпак
караковый	мугӧмсьӧд
каракулевый	каракуль
каракульский	каракуль
карандашный	карандаш
карантинный	карантин
карантинный	карантина
карасёвый	гыч
карельский	карел
карий	мугӧмсьӧд
каркасный	ывъя
карнавальный	карнавал
карнавальный	карнавалса
картинный	серпаса
картонный	картон
картотечный	картотекаса
картофельный	картупель
картофельный	картупеля
картёжный	картіасян
кассовый	касса
кассовый	касса
катерный	катерса
каузальный	помкаа
каучуковый	каучук
кафельный	кафеля
качельный	качайтчан
кашемировый	кашемир
каютный	каютаса
квартирный	квартираса
квитанционный	квитанция
кедровый	сус
керосинный	карасин
керосиновый	карасин
кетовый	кета
кинематографический	кинематография
кинетический	кинетика
кипарисовый	кипарис
кипятильный	пузьӧдчан
киргизский	кыргыз
кирзовый	кирза
кисейный	кисея
кисельный	кисель
кисельный	киселя
кислородный	кислород
кистозный	кистаа
китовый	кит
клавишный	поньтӧда
клапанный	лапӧд
классовый	классъяса
клеевой	лем
клееный	
клеильный	лемалан
клеистый	сира
клеёнчатый	клеёнка
клинический	клиника
клонированный	ӧтвужвуджӧдӧм
клопиный	лудік
клубный	клуб
клубный	клубса
ключичный	вотшлы
кляузный	
клёпочный	клепайтан
княжеский	ӧксы
ковбойский	ковбой
коверкотовый	коверкот
ковочный	дорччан
ковшовый	кӧша
кодировальный	кодируйтан
кодовый	код
козлиный	кӧза
коклюшечный	дзоль
коксовальный	кочуйтан
коксовый	коксуйтчан
колбасный	калбас
колдовской	керана
колебательный	вӧран
колеистый	воргаа
коленкоровый	калинкор
коленный	пидзӧс
количественный	лыда
коллекционный	коллекцияса
колокольный	жыннян
колонный	сюръяяса
колорадский	колорадоса
колхозный	колхоз
колхозный	колхозса
колченогий	
колыбельный	
кольцевой	кытш
кольчатый	кольчаа
колющий	
колющий	
комариный	ном
комбайновый	комбайн
комендантский	комендант
коммунальный	коммунальнӧй
коммуникабельный	сибыд
коммуникационный	йитчан
коммунистический	коммунистическӧй
комолый	сюртӧм
композиционный	тэчас
комсомольский	комсомол
конвейерный	конвейер
конвойный	конвойса
конвульсивный	черӧбталан
конгруэнтный	ӧткодь
конкретизированный	стӧчмӧдӧм
консалтинговый	туйдӧдан
конский	вӧв
конспиративный	гуся
конструкторский	конструктор
консульский	консул
континентальный	континентвывса
контурный	визьӧба
конфискованный	мырддьӧм
коньковый	ӧклупень
коньячный	коньяк
конюшенный	
кооперативный	кооператив
кооперативный	кооперативнӧй
копательный	кодъян
копировальный	копируйтчан
копотливый	
коптильный	тшынӧдан
копчиковый	виклеч
копчиковый	виклечса
копытный	гыжъя
корейский	кореяса
корзиночный	кӧрзинка
коричневый	перкаль
корпулентный	чуртчӧс
коррозионный	сіман
корыстный	
корякский	коряк
космический	космосса
костный	лы
костяной	лы
котлетный	котлет
котловинный	увтас
который	
крабовый	краб
крапчатый	чутӧсь
красильный	мичӧдчан
красноватый	гӧрдов
краткий	дженьыд
кратный	
крейсерский	крейсер
кремлёвский	кремль
кремлёвский	кремльса
кремниевый	кремний
кремниевый	кремния
крепдешиновый	крепдешин
крепколобый	
крепёжный	кутӧдан
кресельный	креслӧ
кресельный	креслӧса
кристаллический	измар
кристаллический	чиръяса
кровельный	вевттьысян
кровянистый	вира
кровяной	вир
кроильный	шӧрасян
кромешный	югдывлытӧм
кромочный	дорыш
кротовый	зымшыр
кроёный	шӧралӧм
круглосуточный	суткичӧжся
крутильный	гартан
крушинный	ошсэтӧр
крылатый	бордъя
крысиный	крыса
кубинский	кубаса
кубический	кубическӧй
кувшинный	кувшин
кудельный	зудӧс
кузнечный	дорччан
кукурузный	кукуруза
кулацкий	кулак
кулинарный	кулинария
кулуарный	гуся
кумачовый	кумач
кумыкский	кумык
купальный	купайтчан
купейный	купе
купейный	купеа
кургузый	
курдский	курд
курной	сьӧд
куропатковый	байдӧг
курортный	курорт
курортный	курортса
курсантский	курсант
курсивный	курсив
курсовой	курсса
курьёзный	тешкодь
кухонный	инпӧвса
лаборантский	лаборант
лавандный	лаванда
лавинный	чукӧра
лавочный	лавкаса
лавровый	лавр
лавсановый	лавсан
лагерный	лагерса
ладанный	ладан
ладный	
лайковый	няр
лакмусовый	лакмуса
лаковый	
лакский	лак
лактационный	лысьтан
лампадный	лампада
лаосский	лао
лапистый	
лапландский	лапландса
лапотный	нинкӧм
латинский	латин
латунный	латунь
латышский	латыш
лебедовый	пӧттурун
лебедовый	пӧттуруна
легкокрылый	
леденистый	йизьӧм
лезгинский	лезгин
лейтенантский	лейтенант
лекарственный	бурдӧдчан
лекторский	лектор
лемешный	амыся
лепестковый	сыръя
лесистый	вӧра
лесопарковый	вӧрпаркса
летальный	кулан
летательный	лэбалан
ливневый	сувтса
лигатурный	сораса
ликвидационный	бырӧдан
ликёрный	ликёр
ликёрный	ликёра
лиловый	гӧрдовлӧз
лиманный	лиманса
лимитный	лимит
линейчатый	визя
линовальный	визьйӧдлам
линованный	визьйӧдлӧм
линялый	
лиственничный	ниа
лиственный	коръя
литовский	литваса
литой	кисьтӧм
лицовочный	банӧдан
личной	чужӧм
лишайный	карс
лобовой	
логический	логика
лодочный	пыж
ложечный	пань
локтевой	гырддза
лосёвый	йӧра
лотерейный	лотерея
лоханочный	лӧкань
лоцманский	нӧсник
лубовый	нин
лубовый	кач
лучезарный	
лучковый	вуджъя
львиный	лев
людской	йӧз
люковый	мур
лютеранский	лютеран
ляписный	ляпис
ляписный	ляписа
лёгочный	ты
магистральный	шӧр
магнитный	магнита
магнитофонный	магнитофон
мадригальный	ошкан(а)
мадьярский	мадьяр
маисовый	маис
майорский	майор
майский	майся
маклерский	сёрнитчӧдан
малопитательный	пӧтӧстӧм
малярийный	малярия
мамонтовый	мамонт
мандатный	мандат
маникюрный	маникюр
мансийский	йӧгра
марганцовый	марганеча
марийский	мари
маринованный	маринуйтӧм
маркизетовый	маркизет
маркировальный	пасъялан
марлевый	марля
маршальский	маршал
маршировочный	маршируйтан
масличный	выйдан
массажный	зыралан
мастеровой	
маститый	
математический	математика
материковый	материк
материнский	петан
матерчатый	дӧра
матрасный	вольпась
матричный	лу
матросский	матрос
матросский	матрос
махорчатый	
машистый	
маятниковый	кывъя
маячный	маяк
мебельный	мебель
медальный	медальса
медистый	ыргӧна
медицинский	медицина
медленный	ньӧжмыд
межбанковский	банккостса
межбиблиотечный	библиотекакостса
междуведомственный	ведомствокостса
междугородный	каркостса
межевой	
межзвёздный	кодзувкостса
межнациональный	войтырпӧвстса
межпланетный	планетакостса
межрегиональный	регионкостса
межрёберный	ордлыкостса
межсоюзный	ӧтувкостса
мездровый	дыж
мелководный	ляпкыд
мемориальный	казьтылан
мериносовый	меринос
мерительный	мурталан
меркантильный	
местоимённый	нимвежтаса
метеоритный	енэжиз
метеорологический	метеорология
меховой	ку
мешкотный	
мигреневый	
миленький	
милиционерский	милиционер
милостивый	
минералогический	доніз
минный	мина
мировоззренческий	видзӧдласа
мирской	
мирской	ӧксьӧм
миткалевый	миткаль
мичманский	мичман
множественный	уна
мобилизационный	мобилизуйтан
мозаический	мозаика
мокротный	шыжа
мокшанский	мокша
молекулярный	молекула
моллюсковый	лёльӧ
молодой	
молотый	изӧм
молоченый	вартӧм
монархистский	монархист
монастырский	манастырса
монашеский	манак
монгольский	монгол
монетный	сьӧм
монополистический	монополистическӧй
монтажный	тэчан
мордовский	мордва
моржовый	морж
морозильный	кынтан
морозный	кӧдзыд
морфологический	морфология
мостовой	пос
мотивировочный	подулалан
мохеровый	мохер
мочалистый	бонзьӧм
мочевой	кудз
мочеполовой	
мошоночный	тобонь
мудрёный	
мундирный	мундирса
муниципальный	муниципалитетса
муравленый	лӧстӧдӧм
муравьиный	кодзувкот
мускулистый	сӧнӧд
мусорный	ёг
мусульманский	мусульман
мутоновый	мутон
мушиный	гут
мыслимый	
мягкотелый	
набедренный	лядьвейвывса
наветренный	тӧвладор
навозный	
нагой	
нагрузочный	сӧвтан
надувной	пӧльтан
надутый	
надутый	польдчӧм
называемый	шусян(а)
найденный	
найденный	сюрӧмтор
наколенный	пидзӧсвывса
налитой	
налоговый	вот
намогильный	гувывса
намётанный	
наплевательский	
наполненный	
нарзанный	нарзан
нарицательный	нима
нарукавный	сойвывса
национальный	войтырсикас
нашатырный	нашатыр
неадекватный	
невиновный	мыжтӧм
невооружённый	оружьетӧм
невылазный	
невыносливый	ляб
недействительный	туйтӧм
недельный	вежонся
недисциплинированный	кывзысьтӧм
недовершённый	помавтӧм
недорогой	донтӧм
недосученный	лаб
недружный	сӧгластӧм
незадачливый	
незамедлительный	нюжӧдтӧм
незамысловатый	прӧстӧй
незаразный	вуджтӧм
незаурядный	торъялан(а)
незваный	кортӧм
незнакомый	
неисследованный	туявтӧм
некий	
некорректный	вежавидзтӧм
некоторый	
неладный	
нелегальный	гуся
нелёгкий	сьӧкыд
немецкий	немеч
ненаучный	туявтӧм
ненецкий	яран
неоплатный	
неосмотрительный	видзчысьтӧм
неосознанный	вежӧрттӧм
непогрешимый	
непорочный	
непочтительный	вежавидзтӧм
непреложный	
непреложный	
непреложный	
непривычный	велавтӧм
неприемлемый	лӧсявтӧм
неприкаянный	
неприкаянный	
непрошеный	кортӧм
неразумный	
нерастворимый	сывтӧм
нерациональный	тӧлктӧм
нерифмованный	муртӧстӧм
несгораемый	сотчытӧм
нескользкий	дзурыд
несминаемый	чукрасьтӧм
несоразмерный	лӧсявтӧм
неспорый	
несчастливый	шудтӧм
несчастный	
несчастный	
нетканый	кытӧм
нетленный	
неугасимый	
неуместный	лӧсявтӧм
неумытый	мыссьытӧм
неучтивый	вежавидзтӧм
неуязвимый	
нехитрый	
нехитрый	
нечеловеческий	
нечёткий	дзуг
неширокий	векньыдик
никакой	
никелевый	никель
никелированный	никелируйтӧм
никчёмный	ковтӧм
нитчатый	
новенький	
ножевой	пурт
нолевой	нолевӧй
норвежский	норвежскӧй
норковый	анча
носильный	новлан
нотариальный	нотариальнӧй
ношеный	новлӧм
нулевой	
обвислый	
областной	обласьт
областной	обласьтувса
обледенелый	йизьӧм
обоснованный	
обоснованный	зумыд
обтирочный	чышкысян
обувной	кӧмкот
обутый	кӧма
общинный	
объединительный	ӧтувтчан
объяснительный	гӧгӧрвоӧдан(а)
объёмный	ыджыд
овсяной	зӧр
огнестойкий	сотчытӧм
огородный	градвыв
огуречный	ӧгуреч
одержимый	
однократный	ӧтчыдъя
одноразовый	ӧтчыдъя
одобрительный	ошкана
ожидаемый	виччысяна
окатанный	майкыд
океанский	океан
оккупационный	оккупация
окладистый	паськыд
околоплодный	пытшпибердса
оконный	ӧшинь
окопный	окопса
ольховый	ловпу
операционный	операционнӧй
оперный	опера
опознавательный	тӧдмалан
опрелый	нёльзьӧм
опросный	юасян
оранжерейный	оранжереяса
организационный	котыртан
ординарный	
орфографический	гижанног
освежительный	ыркӧдан(а)
осетинский	осетин
осетринный	ӧсетрина
осетровый	осётр
осиновый	пипу
ослиный	осёл
особый	
островной	дівывса
отборочный	бӧрйысян
отварной	пуӧм
отверделый	чорзьӧм
отверженный	
откормленный	
откормленный	вердаса
отрывистый	оръясян(а)
отрывной	орйӧдлан(а)
охренный	
охренный	
оценочный	донъялысь
очечный	ӧчки
очковый	ӧчки
пакостный	
палевый	кельыдвиж
пальцевой	чунь
пальчатый	
палёный	чишкалӧм
папиросный	папирос
паразитарный	
пареный	пожӧм
парильный	пӧжсян
паркетный	паркет
паровозный	паровоз
пародийный	пародия
пароходный	паракод
партизанский	партизан
партийный	ютырса
парусиновый	парусина
парусный	тӧвдӧраа
парфюмерный	парфюмернӧй
парчовый	парча
паспортный	паспорт
пастеризованный	сӧстӧммӧдӧм
пастушеский	пастук
пастушеский	пастукалан
пасхальный	ыджыдлунся
патефонный	патефон
патронный	патрон
паховой	йӧрвуждін
пачечный	пачкаа
педагогический	педагог
педагогический	педагогическӧй
пекарный	пӧжасян
пельменный	пельнянь
пенсионный	пенсия
пеньковый	пыш
первый	
пергаментный	пергамент
переводческий	вуджӧдчан
перевозочный	вуджӧдчан
перевязочный	кӧртасян
переговорный	сёрнитан
переменный	вежласян(а)
переправочный	вуджӧдчан
перечный	гормӧга
перпендикулярный	перпендикуляр
перронный	перрон
персидский	персидскӧй
персиковый	персик
персиковый	персика
перцовый	гормӧга
перчёный	гормӧга
песцовый	кынь
пехотный	пехота
пехотный	пехотаса
печной	пач
печёный	пӧжалӧм
пещерный	рудӧгувса
пивной	сур
пиджачный	пинжак
пиковый	вина
пиктографический	серпасъяса
пионерский	пионер
пиратский	пират
писательский	гижан
пискливый	
пистонный	пистона
питательный	пӧтӧс
питьевой	юан
плавильный	сывдан
плаксивый	
плановый	планӧвӧй
пластмассовый	пластмасса
плательный	платтьӧ
платиновый	платина
платяной	паськӧм
пленарный	пленарнӧй
плисовый	плис
плиточный	плитка
плиточный	плиткаа
плохой	
плохой	
плюшевый	плюш
плёвый	
плёночный	плёнкаа
повивальный	
повиликовый	гартчан
повинный	мыжа
поворотный	
повстанческий	кыпӧдчан
подбойный	тувъялан
подбористый	
подвальный	пӧдвал
подгибной	кусыньтчан
подгородный	карбердса
подкладочный	увтыс
подкожный	кучикувса
подколенный	пидзӧс
подлёдный	йиувса
подневольный	
подовый	подвыв
подписной	кырымпаса
подпочвенный	мусинувса
подреберный	ордлыувса
подрядный	пӧдрада
подснежный	лымувса
подсолнуховый	шондіюр
подъездной	
подъязычный	кывувса
подённый	лунысъя
пожарный	кусӧдчан
позапрошлый	воддза
позволительный	позян(а)
позвоночный	сюрсаа
поземельный	му
поисковый	корсьысян
покосный	ытшкан
покраснелый	гӧрдӧдӧм
покупательный	ньӧбасян
покупочный	ньӧбан
полежалый	курдӧм
полемический	вензян(а)
поливальный	киськасян
поливной	киськалан
полинялый	вушйӧм
полковой	полк
полковой	полкса
половинный	джын
положенный	
полотняный	дӧра
полусонный	унзіль
полынный	шыдӧсатурун
польский	поляк
польский	польшаса
полярный	полюс
полярный	полюсдорса;
полярный	войкытшса
помидорный	помидор
помойный	помӧй
порицательный	торшӧдлана
порожистый	коськӧсь
порошковый	порошок
портновский	вурсян
портняжный	вурсян
поршневой	поршеня
порыжелый	гӧрдӧдӧм
поседелый	дзор
посильный	вермана
послевоенный	войнабӧрся
посмертный	кулӧмбӧрся
постилочный	вольсасян
потолочный	йирк
потрёпанный	
похвальный	ошкана
почвенный	му
почечный	вӧрк
почтовый	пошта
почтовый	поштӧвӧй
пошивочный	вурсян
поярковый	нигӧн
поёмный	ойдлан
правдивый	веськыд
правительственный	веськӧдлан
предвоенный	войнаводзвывса
предвыборный	бӧрйысьӧмводзвывса
предгорный	гӧрабердса
предмайский	майводзвывса
предположительный	чайтана
предреволюционный	революцияводзвывса
предсмертный	кулӧмводзвывса
предупредительный	
преклонный	пӧрысь
прибавочный	содтӧд
привозной	вайӧм
привязчивый	
придаточный	содтӧд
прижизненный	ловъядырся
приказной	тшӧктан(а)
принудительный	мырдӧна
приоткрытый	кальк
приставочный	кывводза
пристыженный	яналӧм
пришкольный	школабердса
приёмочный	примитысь
пробковый	пробка
пробочный	пробка
провозной	нуан
проволочный	сутуга
продолговатый	кузьмӧс
прозаический	
производственный	уджалан
проклятый	
промтоварный	промтӧвар
промышленный	промышленнӧй
пропашной	
пропорциональный	тшӧтшнога
просветительский	югдӧдана
прославленный	
простоватый	
простынный	прӧстыня
просяной	проса
проточный	визувтан
процентный	прӧчент
прудовой	пруд
прудовой	прудса
прутковый	гӧгрӧс
прутяной	ньӧр
пряденый	печкӧм
прядильный	печкан
псиный	пон
психиатрический	психиатрическӧй
псовый	пон
публицистический	публицистическӧй
пуганый	повзьылӧм
пунктирный	визьчута
пустяковый	
пуховый	пук
пушечный	пушка
пчелиный	мазі
пшённый	проса
пылевой	бус
пятисотенный	
равнинный	тшӧтшкӧс
равносильный	ӧткодь
радиоэлектронный	радиоэлектроннӧй
разболтанный	
разболтанный	
разборочный	разялан
разбросанный	
разведённый	
разведённый	юксьӧм
развесистый	пашкыр
разветвлённый	
разветвлённый	
развинченный	
развинченный	
разгневанный	
разгневанный	скӧр
разговорный	сёрнитан
разгромный	пасьвартан
раздвоенный	
раздвоенный	вожа
раздетый	
раздольный	
раздробленный	
раздробленный	
раздутый	
разлаженный	
разливочный	кисьтасян
размашистый	
размеренный	
размольный	изан
размягчительный	небзьӧдан
разнородный	сора
разнузданный	
разобщённый	
разобщённый	торъя
разодетый	
разодетый	
разодетый	вӧччӧм
разодранный	
разодранный	
разрывной	чашвартан
разрыхлительный	небзьӧдан
разухабистый	
разъярённый	
ракетный	ракета
ракетный	ракетаа
ракитовый	бадь
раковинный	ракпаня
раковый	рак
раритетный	шоч
расистский	расист
раскалённый	
раскладной	куснясян
раскованный	вӧйсасьтӧм
раскормленный	
раскормленный	тшӧг
расовый	раса
распылённый	посни
рассольный	рӧсола
рассудочный	олтаса
рассыпной	кисьталан
растворимый	сылан
растопочный	ломзьӧдан
растроганный	
растрёпанный	
расценочный	донъялан
расшатанный	
расшивной	вышивайтӧм
расширенный	паськӧдӧм
расшитый	вышивайтӧм
ратификационный	вынсьӧдан
рационалистический	
реакционный	реакционнӧй
реалистический	
ребусный	ребуса
региональный	регионса
редакторский	редактор
режиссёрский	режиссёр
резонный	тӧлка
резусный	резуса
реквизиционный	мырддян
рекордный	вӧвлытӧм
ременный	сюмыс
рентгеновский	рентген
репертуарный	репертуарса
репетиционный	репетиция
репрезентативный	петкӧдлан
репродуктивный	чужтан
реформаторский	вежан
речевой	сёрнитан
римский	римса
рисовый	рис
рисунчатый	сера
ритмичный	
рогожный	рӧгӧза
родниковый	ключ
родословный	
розничный	этшаникӧн
розыгрышный	пудъялан
росистый	лысваа
росный	лысваа
российский	россияса
росяной	лысва
рубашечный	дӧрӧм
рубежный	суа
рудниковый	рудник
рудниковый	рудникса
рудничный	рудникса
русский	роч
рыночный	базар
рюмочный	румка
рябчиковый	сьӧла
ряжевый	пыкӧда
саамский	саам
сабельный	сабля
сажальный	пуктысян
сажевый	са
сакраментальный	
саманный	саман
самоварный	самӧвар
самодийский	яран
самолётный	самолёт
самонадеянный	ыкпаш
самострельный	пезина
самоудовлетворённый	дӧвӧль
самый	
сангвинический	сангвиник
санитарный	санитарнӧй
санскритский	санскрит
сапожный	сапӧг
сапёрный	сапёр
сарафанный	сарапан
саржевый	саржа
сарматский	сармат
сатиновый	сатин
сатураторный	болльӧдан
сафьяновый	сафьян
сборчатый	кӧрӧм
свайный	свая
сварочный	
свекловичный	свеклӧ
светозарный	
свечной	сись
свидетельский	аддзылысь
свинский	
свищеватый	розьӧсь
своеобычный	
своеобычный	
связанный	
связанный	
связанный	йитчӧм
сгорбленный	
сгущённый	
сдаточный	сдайтан
сдельный	лыдысъя
седёлочный	седелка
секретный	гуся
селезёночный	лоп
селекторный	селектор
селекционный	селекция
сельдевый	сельди
сельдяной	сельди
селькупский	сёлькуп
селёдочный	сельди
семенной	кӧйдыс
семенной	кӧдзан
семестровый	семестр
сенатский	сенат
сербский	серб
сердечный	
сереброносный	эзыся
сержантский	сержант
сернистый	тэгъя
сессионный	сессия
сетчатый	тыв
сеялочный	кӧдзан
сжиженный	кизьӧртӧм
сжимный	топӧдан
сивый	
сизый	лӧзовруд
силикатный	силикат
силосный	силос
симметричный	симметрия
симпатический	
симфонический	симфония
синёный	лӧзӧдӧм
сионистский	сионист
сиреневый	сирень
систематичный	
ситцевый	ситеч
сказуемостный	юӧрпас
скальный	крежвывса
скарлатинный	скарлатина
скарлатинозный	скарлатина
скатертный	пызандӧра
скипидарный	скипидар
складской	склад
склеротический	склероз
склизкий	
склочный	
скобельный	гогын
скоромный	
скотный	скӧт
скрипичный	скрипка
скуловой	бандзиб
скульптурный	скульптураса
славянский	славяна
слайдовый	слайда
слесарный	слесаритан
сливовый	слива
слизистый	улимӧсь
слитковый	ёкмыля
слободской	слӧбӧдаса
словарный	кывчукӧр
словарный	кыв
сложносокращённый	дженьдӧдӧма
слоновый	слӧн
слоёный	юкласа
слуховой	кылан
слюдяной	миса
слякотный	
смачный	
смесительный	гудралан
сметанный	нӧкъя
смысловой	вежӧртас
смычковый	вуджъя
смягчающий	кокньӧдан
снайперский	снайпер
сновальный	пансян
сноповый	кольта
соборный	соборса
совиный	сюзь
совместительский	ӧтпыръялан
совхозный	совхозса
согревательный	шонтан
содовый	содаа
соединительный	йитан
солевой	
соляной	
сомкнутый	топыд
сонный	
сорочечный	дӧрӧм
сортовой	сортӧвӧй
сохатый	
социалистический	социалистическӧй
сочинительный	йитласа
спальный	узьлан
спектральный	спектральнӧй
спинной	сюрса
спорный	вензяна
спорый	
ссылочный	ыстысян
стартовый	:
сточный	
стратегический	стратегия
стрельчатый	гумъя
стреляный	
строчёный	стрӧчитӧм
струйный	визласа
струнный	везъя
стыдливый	яндысьысь
стыдный	янӧдан
суковатый	увйӧсь
супружеский	гозъя
суставной	йӧзви
суставчатый	
сухопутный	мувывса
сухощавый	косньӧд
сучёный	путшкӧм
съедобный	сёян
съестной	сёян
съёмный	шедан(а)
сытный	пӧтӧса
табельный	табель
табунный	табун
таджикский	таджик
тазобедренный	
такой	
тальниковый	бадь
танкистский	танкист
танцорский	йӧктан
тарифный	тариф
тарный	тара
татарский	тотар
творительный	
телевизионный	телевизионнӧй
телевизорный	телевизор
тележный	телега
телетайпный	телетайп
телефаксный	телефакс
телефонный	телефон
температурный	температура
теноровый	тенор
тепловой	шоныд
терминологический	термин
термоядерный	термоядернӧй
террористический	террор
террористский	террорист
тесовый	тьӧс
тетеревиный	
тетрадный	тетрадь
тетрадочный	тетрадь
тигровый	тигр
типографский	типографияса
типологический	типология
тиснёный	личкалӧм
титульный	
тканевый	дӧра
тканый	кыӧм
ткацкий	кыан
тлетворный	
тминный	тмин
товарищеский	ёрта
токарный	токар
толевый	толь
толевый	талля
толокняный	тэсь
толоконный	тэсь
толстомордый	
тонкостенный	вӧсни
тоновой	рӧм
топазовый	топаз
топкий	
топонимический	инним
тороватый	
торпедный	торпеда
тортовый	торт
точный	стӧч
тошный	
трактирный	трактир
тракторный	трактор
траловый	трал
трамвайный	трамвай
транзисторный	транзистор
транспортировочный	колльысян
трахейный	горш
трековый	трек
трельяжный	трельяж
тренерский	тренер
тресковый	треска
трестовский	трест
тригонометрический	тригонометрия
триерный	сортируйтан
трикотажный	кыӧм
триумфальный	триумф
троллейбусный	троллейбус
тронутый	
тротуарный	моски
трофейный	трофей
труженический	уджалан
трупный	шой
трюмный	трюм
тряпочный	рузум
трёхгодовой	
трёхразовый	куимысь
туберкулёзный	туберкулёз
тувинский	тыва
тулупный	тулуп
туманистый	руа
туннельный	туннель
тунцовый	тунеч
турбинный	турбина
туристический	туризм
туристский	турист
туркменский	туркмен
тутовый	тутӧвӧй
туфельный	тупли
тыквенный	тыква
тюлевый	тюль
тюльпанный	тюльпан
тюркский	тюрк
тюфячный	перина
тягловый	кыскасян
тёсаный	лӧсалӧм
убойный	
убыстрённый	ӧддзӧдӧм
уважаемый	
увеличительный	ыдждӧдан
уверенный	
уверенный	эскан
увеселительный	гажӧдчан
увесистый	
углеродистый	углерода
углеродный	углерод
угнанный	пышйӧдӧм
уговорный	
удмуртский	удмурт
удойный	йӧла
удэгейский	удэгей
ужинный	ужнайтан
ужиный	уж
ужовый	уж
узбекский	узбек
узкогорлый	юмыр
узорный	
уйгурский	уйгур
укладистый	
украинский	украинаса
укропный	укроп
уксусный	уксус
уловистый	
уловный	
улучшенный	бурмӧдӧм
уменьшительный	ичӧтмӧдан
умывальный	мыссян
университетский	университет
университетский	университетса
уничижительный	
уполномоченный	уполномоченнӧй
управленческий	веськӧдлан
управляемый	веськӧдлан
упрощенческий	веркӧса
ускорительный	ӧддзӧдан
усовершенствованный	бурмӧдӧм
уступчатый	тшупӧда
утвердительный	эскӧдан(а)
утиный	утка
ухарский	
ухватный	укват
уценённый	донтӧммӧдӧм
учебный	велӧдчан
учительский	велӧдысь
ушной	пель
ущелистый	сёртасъяса
фабульный	сюрӧс
файловый	файл
факультативный	
факультетский	факультетса
фанерный	фанера
фантасмагорический	шобрӧдлан
фармацевтический	фармация
фартовый	
фатальный	
федеральный	федеральнӧй
федеративный	федерация
федеративный	федеративнӧй
феерический	
фельетонный	фельетон
феминистский	феминист
феноловый	фенола
фенологический	фенология
ферментный	фермент
фермерский	фермер
фестивальный	фестиваль
фетровый	гын
фигуристый	
фигуристый	
физиологический	физиология
физиотерапевтический	физиотерапия
фиктивный	
филармонический	филармония
филармонический	филармонияса
филателистический	филателист
филологический	филология
финиковый	финик
финифтевый	финифть
финишный	помасян
фиордовый	куръя
фитильный	петеля
фланговый	фланг
фланелевый	помазея
флейтовый	флейта
флективный	флективнӧй
флотский	флот
флюорографический	флюорография
фольговый	фольга
фольклорный	фольклор
фонарный	пӧнар
фонетический	фонетика
фонологический	фонология
форелевый	форель
формализованный	ногалӧм
фортепьянный	фортепьяно
фортификационный	водзсасян
фосфорный	
фототелеграфный	фототелеграф
фрагментарный	
фразеологический	кывтэчас
франтоватый	
фрахтовый	фрахт
фтористый	фтора
фундаментальный	
фундаментный	подув
фуражный	кӧрым
фургонный	фургона
футбольный	футбол
хакасский	хакас
халвовый	халва
халтурный	
ханский	хан
хипповый	дурк
хирургический	хирургия
хитроумный	
хлипкий	
хлопковый	туруншӧрт
хлопотный	
хлопчатобумажный	бумазея
хлопчатый	бумазея
хлюпкий	
хмелевой	таг
хмелевой	тагъя
хоженый	
хозяйственный	овмӧсса
хоккейный	хоккей
холерный	холера
холощёный	кодзӧм
холстинный	дӧра
холстяной	дӧра
холуйский	
холщовый	дӧра
хорватский	хорватияса
хореографический	йӧктан
хоровой	хор
хорошенький	
храмовой	вичко
христианский	кристоса
хромистый	хрома
хромовый	хрома
хрящевой	гырчкана
худородный	
хулиганский	кулиган
царистский	саралан
цедильный	сысъясян
цеженый	
целевой	могмӧдан
целинный	эжа
целлофановый	целлофан
целлюлозный	целлюлоза
цементный	цемент
ценительский	донъялан
ценовой	дон
центровальный	
центровой	шӧр
цеплятельный	тшапкысян
цепочечный	чеп
цеховой	цех
цеховой	цехса
цигейковый	цигейка
циклонный	гумыльгаа
цинковый	цинк
циновочный	рӧгӧза
цитатный	цитата
цитатный	ыстысян
циферблатный	циферблат
цокольный	подувса
цуговой	звӧйкъя
цукатный	цуката
цыганский	чиган
чартерный	чартер
частушечный	частушка
чековый	чек
чемпионский	чемпион
чепуховый	
черепаховый	черпаха
черепичный	черепича
черепяной	сёй
чересседельный	седелка
черкесский	черкес
черничный	чӧд
черничный	чӧдъя
черногорский	черногорияса
черномазый	
чертовский	
черёмуховый	льӧм
черёмуховый	льӧмъя
чесальный	
чесночный	чеснӧк
чесучовый	чесуча
чечевичный	чечевича
чеченский	чечен
чешуйный	сьӧм
чешуйный	килля
чиновнический	чина
читальный	лыддьысян
чихательный	несйӧдлан
членский	шлен
чубарый	пегана
чувашский	чуваш
чудаческий	тешкодь
чумной	
чётный	тшӧта
шагреневый	шагрень
шалфейный	шалфей
шалый	
шапочный	шапка
шариковый	шарикӧвӧй
шарнирный	дзир
шахматный	шахмат
шахтный	шахта
шведский	швед
швейный	вурсян
швейцарский	швейцарияса
шелудивый	
шерстобитный	летчан
шестерной	
шикарный	
шинельный	шынель
шинковальный	шыран
шиферный	шипер
шифоновый	шифон
шкафный	шкап
шквальный	
шкиперский	шкипер
школьный	
шляпный	шляпа
шляпочный	шляпта
шмелиный	мазі
шнуровой	кӧвъя
шовинистский	шовинист
шовный	
шоссейный	туй
шотландский	шотландса
шпажный	шы
шпинатный	шпинат
шпионский	шпион
шпулечный	шпулька
шрифтовой	гижӧбтаса
штабной	
штабной	штабса
штамбовый	вожтӧм
штамповочный	штампуйтчан
штапельный	штапель
штатский	
штатский	штатскӧй
штатский	
штемпельный	пасйӧг
штепсельный	штепсель
штифтовой	тув
штормовой	шторм
штормовой	бушкола
шторный	занавес
штурвальный	веськӧдлан
штурвальный	
штурманский	штурман
шубный	пась
щёточный	щӧтка
эвакуированный	
эвакуированный	эвакуируйтӧма
эвенкийский	эвенк
эвенский	эвен
эвкалиптовый	эвкалипт
эвристический	эвристика
эквадорский	эквадорса
экваториальный	
эквилибристический	эквилибристика
экзаменационный	экзамен
экий	иопред.
экранный	экран
экскаваторный	экскаватор
экскурсионный	экскурсия
экспедиторский	экспедитор
экспериментаторский	экспериментатор
экспертный	эксперт
эксплуататорский	нартитан
эксплуатационный	вӧдитчан
экспортный	экспорт
экстрактный	экстракт
экстрактовый	экстракт
экстракционный	
элегантный	
электромагнитный	электромагнит
электромеханический	электромеханическӧй
электротехнический	электротехника
элитарный	медбур
эмбриональный	пытшпи
эмигрантский	эмигрант
эмиграционный	эмиграция
эмульсионный	эмульсия
энецкий	энеч
энский	ӧти
энцефалитный	энцефалит
эпидемический	пӧрӧс
эпохальный	эпоха
эрзянский	эрзя
эскадронный	эскадронса
эскимосский	эскимос
эстафетный	эстафета
эстонский	эст
эстрадный	эстрада
этимологический	этимология
этнический	войтыр
этнографический	этнография
юбочный	юбка
югославский	югославияса
юкагирский	юкагир
юмористический	серамбана
юнкерский	юнкер
ютовый	бӧжладорса
ягельный	ялаа
ягодичный	бек
ягуаровый	ягуар
ядрёный	
язёвый	сын
якорный	якӧр
якутский	якут
яловый	
ямбический	ямб
ямской	
ямской	
японский	японса
ясачный	
ёлочный	ёлка
ёлочный	ёлкаса
ёмкий	ыджыд
абсолютно	тырвыйӧ
автономно	асъюралӧмӧн
азартно	яра
апатично	веськодя
априори	водзвыв
барашком	читкыльӧн
безбожно	яндысьтӧг
безвозбранно	мытшӧдтӧг
безгранично	помтӧг
безжизненно	сырк
безответственно	кывкуттӧг
безотчётно	отчёттӧг
безудержно	ӧвсьытӧг
безустанно	мудзлытӧг
безутешно	бурасьлытӧг
бережливо	
беспокойно	шукӧб
беспредельно	помтӧг
беспристрастно	веськыда
бессменно	помвыв
бессмысленно	лӧсявтӧг
бессовестно	яндысьтӧг
бессознательно	гӧгӧрвотӧг
бесспорно	
бесстрашно	повтӧг
бесхозяйственно	идӧртӧма
бесчестно	яндысьтӧг
бесчувственно	садьтӧг
битком	
блаженно	дӧвӧльпырысь
бледно	кельыда
близко	
близко	матын
близко	бура
болезненно	дойдана
больно	
босиком	кӧмтӧг
брюзгливо	зьвага
важно	
важно	колӧ
валко	дзибыра
вверху	вылын
ввосьмером	кӧкъямысӧн
вгорячах	скӧрйылысь
вдали	ылын
вдвоём	кыкӧн
вдевятером	ӧкмысӧн
вдесятером	дасӧн
вдруг	ӧтпырйӧ
вдруг	
везде	быдлаын
вернее	
верно	
верхом	верзьӧмӧн
весело	
весной	тулысын
вживе	ловйӧн
взамен	воча
взатяжку	ньылалӧмӧн
взахлёб	сьӧмдытӧдз
взашей	тодмышкалӧмӧн
видимо	тыдавмӧн
винтообразно	гартолӧн
виртуозно	мастака
вкруговую	ылӧсас
вкусно	азыма
влёт	лэбигӧн
внакидку	шлавгӧмӧн
внакладе	
внакладку	сакаралӧмӧн
внаклонку	копыртчӧмӧн
вольно	зэлӧдчытӧг
вон	ортсӧ
вон	
вон	
воровски	гусьӧн
восемью	кӧкъямысысь
востро	
вперегонки	смотри:вперего́нки
вперёд	водзвыв
вприглядку	видзӧдӧмӧн
вприкуску	курччышталӧмӧн
вприпрыжку	чеччалігтырйи
впрок	
впросак	рӧсплӧкӧн
впросонках	унйылысь
впятером	витӧн
вразброс	койӧмӧн
вразнос	новлӧдлӧмӧн
вразрез	
вразрядку	костӧдлӧмӧн
врастяжку	нюжйӧдлӧмӧн
врозь	паськӧдӧмӧн
всего	сӧмын
всемером	сизимӧн
вслепую	видзӧдтӧг
вспыльчиво	чизыра
всухомятку	ютӧг
всухую	косӧн
всё	ӧнӧдз
втайне	гусьӧн
втроём	куимӧн
втуне	весьшӧрӧ
вчера	тӧрыт
вчетвером	нёльӧн
вчистую	дзикӧдз
вшестером	квайтӧн
выгодно	
выгодно	кивыв
выжидательно	водзмӧстчытӧм
высоко	вылӧ
гадко	
гладко	иперен.
гладко	шыльыда
глубоко	ёна
глубоко	зумыда
глубоко	
глубокомысленно	думыштчӧмӧн
глухо	
годами	воясӧн
голышом	пасьтӧг
горестно	
горестно	шог
горько	курыда
горько	
горько	курыд
грубо	кикурӧда
грустно	
грязно	няйта
грязно	
грязно	няйт
гужом	вӧлӧн
гуртом	чукӧрӧн
гуртом	гузьӧбӧн
давеча	ӧнтай
далеко	
далеко	ылын
девятью	ӧкмысысь
действительно	
деликатно	вежавидзӧмӧн
демонстративно	вежавидзтӧг
денно	
десятью	дасысь
диаметрально	
дипломатически	мудера
добро	бур
доброкачественно	бура
добротно	бура
доверительно	эскана
довольно	тырмымӧн
довольно	
доказательно	эскӧдана
докрасна	гӧрдӧдз
дома	гортын
домой	гортӧ
донага	пасьтӧг
донизу	уліӧдз
доныне	ӧнӧдз
доподлинно	стӧча
дополна	чукйӧн
дополнительно	содтӧд
дорогой	дона
досиня	лӧзӧдтӧдз
доступно	гӧгӧрвоана
досуха	косӧдз
дотемна	пемдытӧдз
доходчиво	гӧгӧрвоана
дочерна	сьӧдӧдз
дочиста	сӧстӧмӧдз
дочиста	кушӧдз
дрожмя	тіралӧмӧн
дурно	
единогласно	ӧтсӧгласӧн
единолично	ӧткӧн
естественно	
ехидно	лӧгпырысь
ещё	на
ещё	
жалко	
жалко	
жалко	жаль
жарко	жара
жарко	
жестоко	чорыда
живмя	
живо	ёна
жирно	
жирно	кыза
жутко	
жёлчно	лӧга
забавно	тешкодя
забавно	
забавно	тешкодь
завидно	
завтра	аски
задаром	весь
задиристо	жлеча
залпом	залпӧн
замедленно	надзмӧдӧмӧн
заметно	
замкнуто	ӧтдортчӧмӧн
замуж	
запросто	кокниа
заранее	водзвыв
заумно	гӧгӧрвотӧма
здорово	бура
зло	лёк
зорко	сюся
избирательно	бӧрйӧмӧн
излишне	
изолированно	торйӧн
иначе	
индифферентно	веськодя
интересно	
интересно	бур
иронически	серавлӧмӧн
искусственно	киӧн
исподтишка	гусьӧн
испуганно	повзьӧмӧн
истинно	
кзади	бӧрлань
кисло	гажтӧма
кисло	
кисло	чизыр
кичливо	ыкшаа
клином	кокалӧн
кнаружи	ортсылань
книзу	кывтчӧс
кнутри	пытшлань
коллегиально	ӧтвылысь
компактно	топыда
конвульсивно	черӧбтӧмӧн
конкретно	стӧча
конспективно	дженьыда
конспиративно	гусьӧн
конфиденциально	гусьӧн
коротко	дженьыда
косяком	пӧлӧсӧн
красиво	
красиво	мича
красочно	яръюгыда
крепко	зурыда
крепко	кам
кропотливо	зіля
кротко	рама
крохотка	
крошка	
кругом	гӧгӧрпӧв
крупно	гырыся
крупно	шольгӧма
крупно	ыджыда
круто	чорыда
круто	сьӧкыд
кстати	
кудряво	тшапитӧмӧн
курьёзно	тешкодя
лава	изрок
лава	
лава	люзьгӧмӧн
ладком	сӧгласӧн
ладно	
ладно	
ладно	тырмас
ласково	меліа
лениво	ньӧжмыда
лестно	нимкодь
лихачески	удала
лихо	сьӧкыд
ловко	
ловко	
лучше	
лучше	бурджык
лучше	
лучше	стӧчджыка
льзя	позьӧ
льстиво	лесьта
любопытно	зэв
любопытно	
мастерски	кужӧмӧн
матерно	матькӧмӧн
мглисто	
мглисто	руа
между	предлог
между	костын
между	костын
мелко	посниа
мелко	
мелодично	мылаа
мелочно	артасьӧмӧн
мельче	посниджыка
мельче	посниджык
менторски	велӧдӧмӧн
мерзко	
мертвецки	
мертво	
месяцами	тӧлысьясӧн
мешкотно	ньӧжмыда
милостиво	бурпырысь
мимоездом	мунігмоз
мимоходом	мунігмоз
мимоходом	пырмунігмоз
много	уна
многовато	унакодь
мрачно	
мстительно	косӧдана
мудрено	
мудрено	сьӧкыд
мягко	небыда
набок	боквыв
набок	бокшӧн
навалом	
наверх	вывлань
навыворот	
навыкате	былькъя
навыпуск	лэдзалӧмӧн
навырез	вундалӧмӧн
навытяжку	
наглухо	топыда
наголо	кушӧдз
наголову	
наизнанку	бӧрӧн
наизусть	наизусьт
наизусть	бура
наконец	
накрепко	топыда
налево	бокӧ
наоборот	
наоборот	мӧдарӧ
наперечёт	
наперечёт	лыда
напоследок	бӧрӧдз
напутственно	туйдӧдана
наравне	ӧтвесьтын
нарочито	тӧдчӧдана
насухо	косӧдз
натурально	ассерног
наутек	лататы
начерно	мичмӧдтӧг
начисто	
начисто	
невозможно	
невредно	
невыносимо	
недалеко	
недоверчиво	эскытӧма
недостойно	
недурно	
недурно	лӧсьыд
нежарко	
незначительно	тӧдчытӧма
незыблемо	зумыда
неизбежно	быть
неизвестно	
нелюдимо	кида
немилосердно	этштӧг
неминуемо	быть
немного	
необоснованно	подувтӧг
необыкновенно	зэв
необычайно	вӧвлытӧма
неоднократно	унаысь
неосознанно	вежӧрттӧг
неосторожно	видзчысьтӧг
неотрывно	дугдывтӧг
неотступно	личлэдзлытӧг
неплотно	коста
неповоротливо	укшаля
непосредственно	веськыда
неприлично	
неприятно	дӧсаднӧ
неразлучно	янсӧдчывтӧг
неразумно	шогмытӧма
нерасчётливо	видзтытӧг
нередко	тшӧкыда
несдержанно	згӧвӧра
неспокойно	
неуверенно	дзибрӧса
неуверенно	тӧдтӧмпырысь
неудобно	
неудовлетворительно	лёка
неустойчиво	дзибрӧса
неуютно	гажтӧм
нехорошо	
нечестно	
неярко	пемыда
низко	ляпкыда
низко	уліті
низко	
низко	улын
нудно	
ныне	ӧні
ныне	талун
нынче	талун
нынче	ӧні
обидно	
обок	орччӧн
обратно	бӧр
обратно	мӧдарӧ
одухотворённо	кыпыда
оземь	муӧ
опасно	
опасно	ӧпаснӧ
оптимистично	кыпыда
оптом	чукӧрӧн
оранжево	вижовгӧрда
ориентировочно	ылӧсас
основательно	пыдісянь
основательно	поводнӧя
особенно	торъя
особо	торъя
особо	торйӧн
остроумно	востера
отвесно	чуркӧса
ответственно	кывкутӧмӧн
отныне	ӧнісянь
отрадно	нимкодь
отрадно	
отрадно	нимкодь
официально	официальнӧя
ощутительно	тӧдчымӧн(ъя)
панибратски	вежавидзтӧг
печально	
пешком	подӧн
письменно	гижӧмӧн
питательно	пӧтӧса
плавно	нюдза
плашмя	пласьт
плоско	плавкӧса
плотно	топыда
плохо	
побоку	веськодь
повелительно	тшӧктана
поголовно	ӧтитӧг
подряд	пӧдрад
подчистую	кушӧдз
подчёркнуто	тӧдчӧдана
подённо	лунысйӧн
позавчера	войдӧрлун
позади	сайын
позволительно	позяна
поздно	сёрӧн
поздно	
поздно	сёр
поимённо	нимӧн
пока	на
пока	аддзысьлытӧдз
поначалу	первойсӧ
понимающе	гӧгӧрвоана
пополам	шӧриӧн
пополам	шӧриа
пораньше	водзджык
порывисто	джӧма
послезавтра	аскомысь
послушно	кывзысьӧмӧн
посуху	косінті
потешно	тешкодя
пошло	мисьтӧма
поштучно	лыдӧн
правдиво	веськыда
правильно	
превосходно	
предвзято	подувтӧг
предосудительно	дивитана
предположительно	ылӧсас
прекрасно	
приблизительно	ылӧсас
привычно	тӧданавылысь
прилежно	зіля
прискорбно	
пристыженно	яналӧмпырысь
приятно	
продолговато	кузьмӧса
продолжительно	кузя
проницательно	тӧдмалана
просто	
просто	
просторно	
прочь	бокӧ
прямиком	весьтас
путано	дзугсьӧмӧн
пуще	ёнджыка
пыльно	буса
равно	
равно	лоӧ
равнодушно	веськодя
радостно	
разбросанно	дзуга
развалисто	катласьӧмӧн
разгонисто	паськыда
рано	водз
рано	кості
раскатисто	гылыда
расплывчато	рудӧбӧн
рассеянно	веськодя
резко	ясыда
ремесленно	кикурӧда
ровно	
рядком	орччӧн
рядом	орччӧн
самонадеянно	ыкпаша
самоходом	подӧн
светло	
светло	югыд
светло	
свободно	асшодйӧн
свободно	повтӧг
свободно	
свободно	прӧст
свой	ас
свой	
свысока	вылісянь
свыше	енсянь
сегодня	талун
сегодня	талун
сейчас	ӧні
семью	сизимысь
сердито	ярскӧба
серо	гажтӧма
серо	
серо	рӧмыд
серьёзно	збыльысь
силком	мырдӧн
скверно	
сквозь	предлогвин.п.что
скользко	
скоро	регыд
скучно	гажтӧм
скучно	
скучно	гажтӧм
слабо	личыда
слабо	небыда
сладко	чӧскыда
сладко	
сладко	юмов
случайно	
слёзно	бӧрдӧмӧн
смело	повтӧг
смертельно	кувмӧн
смешно	тешкодь
смешно	
смиренно	рама
смутно	омӧля
смутно	
смутно	
смутно	шуштӧм
снаружи	ортсысянь
сначала	войдӧр
снизу	кывтыдсянь
соблазнительно	ыштӧдана
совершенно	ньӧти
сокращённо	дженьдӧдӧмӧн
сочно	улиса
спереди	водзын
сплеча	кимльӧскивыв
сплошь	пасьтала
сплошь	дорвыв
сразу	ӧтпырйӧ
сродни	
сродни	рӧдня
сряду	дорвыв
степенно	вежавидзӧмӧн
стоймя	сувтсӧн
стоя	сувтсӧн
странно	
страсть	вирби
строго	чорыда
строго	стӧча
сумрачно	букыша
сухо	
сухо	кос
таинственно	гусьӧн
таинственно	гӧгӧрвотӧма
темно	пемыда
темно	
темно	пемыд
теперь	ӧні
тепло	шоныд
тепло	шоныдін
тепло	шоныда
тепло	
тепло	шоныд
тепло	
тепло	шоныд
терпеливо	дӧзмытӧг
тесно	топыда
тесно	
тесно	дзескыд
тесно	
тихо	
толком	гӧгӧрвоана
толсто	кыза
томно	
томно	сьӧкыд
тонко	сюся
топорно	кикурӧда
торжественно	кыпыда
торжественно	
торжественно	кыпыд
торовато	лышкыда
тоскливо	
тревожно	
трезво	ютӧг
третьёводни	войдӧрлун
трижды	куимысь
трудно	
трудно	
трудно	сьӧкыд
трусливо	полӧмпырысь
тряско	зуркыда
тряско	
тряско	зӧркыд
туго	зэлыда
туго	топыда
туго	
туго	
туманно	руа
туманно	
туманно	гудыр
тягостно	сьӧкыда
тягостно	
тяжело	сьӧкыда
тяжело	
тяжко	сьӧкыда
тяжко	
увалисто	катласьӧмӧн
уверенно	падъявтӧг
уверенно	зумыда
уверенно	эскӧмпырысь
углубленно	пыдісянь
угодливо	лесьта
удивительно	
удивительно	дивӧ
удобно	кивыв
удобно	
удобно	лӧсьыд
удовлетворённо	могмӧмавылысь
уединённо	ӧткӧн
уж	нин
ужасно	лёка
ужасно	
ужасно	
ужасно	сьӧкыд
уже	нин
узко	
украдкой	гусьӧн
уместно	
умеючи	кужӧмӧн
уморительно	
уморительно	тешкодь
умственно	вежӧрӧн
уныло	
упорно	азыма
уродливо	мисьтӧма
уродливо	модатӧма
успешно	бура
успокаивающе	лӧньӧдана
устойчиво	зумыда
утвердительно	эскӧдӧмпырысь
утомительно	
уютно	
уютно	
уютно	лӧсьыд
философски	лабутнӧя
формально	веськодьпырысь
франтовски	тшапа
хмуро	
хмуро	
холодно	
холодно	кӧдзыд
холодно	
холодно	кӧдзыд
хорошо	бура
хорошо	
хорошо	
хорошо	
хорошо	лӧсьыд
целиком	тырвыйӧ
целомудренно	вежавидзӧмӧн
цугом	звӧйкйӧн
чадно	кольмӧдана
чадно	
чадно	чад
чего	мый
черно	сьӧда
черно	
черно	
чисто	сӧстӧма
чисто	мичаа
чисто	сӧдза
чисто	
чисто	сӧстӧм
чисто	
чудесно	
чудно	тешкодя
чудно	
чутко	сюся
чутко	кокниа
чутко	стӧча
чётко	ясыда
чётко	ярскӧба
шагом	восьлӧн
шестью	квайтысь
широко	паськыда
широко	паськыда
щедро	лышкыда
экономично	видзтӧмӧн
эксцентрически	тешкодя
эскизно	ылӧсас
юзом	юзӧн
явственно	явӧ
яро	яра
ясно	
ясно	
ясно	гӧгӧрвоана
ясно	
Арктика	Арктика
завтра	аски
Цельсий	Цельсий
аберрация	ясыдтӧмлун
аберрация	ылалӧм
абонемент	абонемент
абрикос	абрикос
абсолют	ен
абстракция	абстракция
абсурд	лӧсявтӧмтор
абсурдность	лӧсявтӧмлун
аванзал	водзпом
авиабаза	авиабаза
авиабомба	авиабомба
авиагоризонт	авиавежтас
авиадесант	авиадесант
авиалиния	авиавизь
авиамодель	авиамодель
авиапочта	авиапошта
авиапредприятие	авиауджаин
авиасвязь	авиайитӧд
авто	автомобиль
автобус	автобус
автоинспекция	автоинспекция
автокамера	автокамера
автоколонна	автоколонна
автол	автол
автолавка	автолавка
автомат	автомат
автоматизация	автоматизируйтӧм
автоматика	автоматика
автомобилист	автомобилист
автомобиль	автомобиль
автономия	асъюралӧм
автопарк	автопарк
автоплуг	автогӧр
автопоезд	автопоезд
авторство	авторалӧм
авторучка	авторучка
автотранспорт	автотранспорт
автотрасса	автотуй
агат	агат
агент	агент
агентство	агентство
агитация	агитация
агитпункт	агитпункт
агнец	
агрегат	агрегат
агрессия	
агроном	агроном
агрономия	агрономия
агротехник	агротехник
адаптация	кокньӧдӧм
адвокатура	адвокаталӧм
адвокатура	адвокатъяс
адекватность	ӧткодьлун
администратор	администратор
администрирование	администрируйтӧм
адмирал	адмирал
адмиралтейство	адмиралтейство
адъютант	адъютант
ажур	синчӧж
азартность	ярлун
азбука	анбур
азбука	шыпаскуд
азбука	подув
азиат	азияса
азимут	азимут
азот	азот
азям	дукӧс
айва	айва
айсберг	йиді
академик	академик
академия	академия
аканье	акайтӧм
акация	акация
акварель	вап
аквариум	черигорт
аккорд	аккорд
аккордеон	аккордеон
аккредитив	аккредитив
акробат	акробат
аксиома	аксиома
акт	петкӧдчӧм
актуальность	коланлун
актёрство	актёралӧм
акула	акула
акушерство	гӧгинялӧм
акцент	ударенньӧ
акцепт	ладмӧдчӧм
алгебра	алгебра
алебастр	вальді
алкоголь	спирт
аллергия	аллергия
аллея	аллея
алмаз	алмаз
алтын	алтын
алфавит	анбур
алхимик	алхимик
алхимия	алхимия
алыча	алыча
альбом	альбом
альпинист	альпинист
альпинистка	альпинистка
альт	альт
альчик	шег
амба	пом
амбулатория	бурдӧдчанін
аммоний	аммоний
амнистия	амнистия
ампер	ампер
ампула	ампула
ампутация	вундӧм
амулет	видзӧг
амфибия	амфибия
амёба	амёба
аналог	ӧткодьтор
аналогия	ӧткодьлун
ананас	ананас
анархизм	анархизм
анархист	анархист
анекдот	шмонь
анемия	малокровие
анимация	ловзьӧдӧм
анимизм	
анис	анис
анод	анод
аномалия	нелючкитор
антагонизм	миритчытӧмлун
антилопа	антилопа
антитеза	паныдлун
антиципация	
антрополог	антрополог
антураж	матігӧгӧр
аорта	аорта
апатит	апатит
апатичность	веськодьлун
апатия	веськодьлун
апельсин	апельсин
аппарат	аппарат
аптека	аптека
аранжировка	
арап	плут
арахис	арахис
арбуз	арбуз
ареал	мутас
арендатор	кӧртымалысь
ариозо	ариозо
аристократ	аристократ
арифметика	арифметика
арифмометр	арифмометр
ария	ария
аркан	няртала
арматура	арматура
армеец	армееч
армия	армия
ароматизация	чӧскӧдӧм
артель	чукӧр
артельщик	артельса
артикль	артикль
артиллерист	артиллерист
артиллерия	артиллерия
артист	артист
артистка	артистка
арфа	арфа
археолог	археолог
архив	архив
архитектор	архитектор
архитектура	архитектура
асбест	асбест
аскетизм	аскетизм
аспирант	аспирант
аспирантка	аспирантка
аспирантура	аспирантура
аспирин	аспирин
ассамблея	бал
ассонанс	
ассорти	сорас
астра	астра
астронавт	астронавт
астронавтика	астронавтика
астроном	астроном
астрофизика	астрофизика
асфальт	асфальт
асфальтирование	асфальталӧм
атавизм	коляс
атаман	атаман
атлет	атлет
атлет	багатыр
атлетика	атлетика
атом	атом
атрофия	
атташе	атташе
аттестат	аттестат
аттракцион	аттракцион
аудит	ревизия
аудитор	ревизор
аукционер	аукционер
аура	югӧр
аура	асгӧгӧртас
аут	аут
аутентичность	збыльлун
аутотренинг	асызйӧг
афоризм	шусьӧг
аффикс	аффикс
аффриката	аффриката
ацидолакт	ацидолакт
аэробус	аэробус
аэровокзал	аэровокзал
аэроплан	аэроплан
аэропорт	аэропорт
аэростат	аэростат
бабаханье	швачкӧбтӧм
бабочка	бобув
багет	багет
багор	багыр
бадминтон	бадминтон
бадья	чепня
база	подув
база	база
база	видзанін
базис	подув
бакалавр	бакалавр
бакен	бакен
баклажан	баклажан
бактериолог	бактериолог
бактериология	бактериология
бал	бал
балаболка	
балаган	балаган
балалайка	балалайка
балахон	балахон
балерина	балерина
балет	балет
балетмейстер	балетмейстер
балкон	балкон
балл	балл
баллада	баллада
балласт	сьӧктӧд
балласт	ковтӧмтор
баллистика	баллистика
баллон	баллон
баллотировка	баллотируйтӧм
баловень	
баловень	
баловство	
бальзам	бальзам
бамбук	бамбук
банан	банан
бандаж	шына
бандероль	бандероль
бандит	бандит
бандитизм	бандиталӧм
бандура	бандура
банкет	банкет
бант	бант
бантик	бантик
баня	пывсян
баня	пывсьӧм
баптист	баптист
барабан	барабан
барабан	тӧбӧд
барак	барак
барахло	
барбарис	барбарис
барда	раб
баржа	баржа
барий	барий
барин	барин
баритон	баритон
баркас	баркас
барокко	барокко
барометр	барометр
барон	барон
баррикада	баррикада
барс	барс
барсук	барсук
бархат	бархат
барьер	стойка
баскетбол	баскетбол
басня	басня
бассейн	варччанін
бастион	бастион
бастующий	бастуйтысь
батальон	батальон
батарея	батарея
батист	батист
батог	бедь
батон	батон
батрачество	батракъяс
батюшка	бать
батюшка	поп
батя	бать
башлык	башлык
башмак	башмак
башня	башня
баян	баян
беганье	котралӧм
бегемот	бегемот
бегония	бегония
бегун	котралысь
беда	
беда	
беда	
безвинность	мыжтӧмлун
безволие	небыдлун
бездарность	тӧлктӧмлун
безделица	
бездельничанье	немуджтӧмалӧм
безе	безе
безжалостность	нартлун
беззубка	ракпань
безмен	безмен
безнадзорность	дӧзьӧртӧмлун
безнаказанность	мыждытӧмлун
безоблачность	сэзьлун
безобразие	пакӧсьт
безответственность	кывкуттӧмлун
безотцовщина	батьтӧмлун
безработица	уджтӧмалӧм
безразличие	веськодьлун
безрукавка	сӧстӧм
безумие	йӧйталӧм
безумство	
безынициативность	водзмӧстчытӧм
бейсбол	бейсбол
бекас	енмеж
белена	пӧттурун
белка	ур
белуга	белуга
бельмо	тус
бельчонок	урпи
беляк	
беляк	кӧч
белёк	тюленьпи
бензин	бензин
бензол	бензол
берданка	берданка
берет	берет
берёста	сюмӧд
бескорыстие	артасьтӧмлун
беспамятность	выжывлун
беспрецедентность	вӧвлытӧмлун
беспристрастие	веськыдлун
бессмертие	
бессмысленность	тӧлктӧмлун
бессовестность	яндысьтӧмлун
бесстрашие	повтӧмлун
бесстыдство	яндысьтӧмлун
бестактность	сямтӧмлун
бесхлебица	тшыгъяландыр
бесхозяйственность	идӧртӧмлун
бесцветность	рӧмтӧмлун
бесцельность	пӧльзатӧмлун
бесчестность	яндысьтӧмлун
бесёнок	вильышпоз
бетон	бетон
бефстроганов	бефстроганов
бзик	тешкодьлун
биатлон	биатлон
библиограф	библиограф
библия	библия
бизнес	бизнес
бизнесмен	бизнесмен
билет	билет
било	кыв
било	чап
бильярд	бильярд
бинокль	бинокль
бином	бином
бинт	бинт
биография	олантуй
биолог	биолог
биология	биология
биофизика	биофизика
биохимия	биохимия
биржа	биржа
бирюк	кӧин
бисер	бисер
бисквит	бисквит
биссектриса	биссектриса
битум	битум
бифштекс	бифштекс
благовещение	благовещенньӧ
благодать	
благословение	ошкӧм
благочестие	енногалун
блаженство	красуйтчӧм
бланк	бланок
блевотина	вос
блеск	
блесна	кыснан
блеф	пӧрйӧг
близость	матыслун
близость	ӧткодьлун
блин	блин
блиндаж	блиндаж
блокнот	блокнот
блоха	пытш
блузка	ковта
блюдо	тасьті
блюминг	блюминг
бляха	пража
блёклость	быгыдлун
бобок	
бобр	мой
бобёр	
богиня	
бодяга	бодяга
бодяк	
божество	ен
бойкот	бойкот
бок	бок
бокал	бокал
боксит	боксит
болото	дудӧм
болт	болт
большевизм	большевизм
большевик	большевик
болячка	дой
бомба	бомба
бомбардирование	бомбардируйтӧм
бомбардировка	бомбардируйтӧм
бомбардировщик	бомбардируйтысь
бомбёжка	бомбитӧм
бона	бона
бонус	
бонус	премия
боржоми	боржом
борода	тош
борозда	гежӧм
борт	борт
борщ	борщ
борщевик	азьгум
босс	юркутысь
босяк	зимогор
ботало	бурскан
ботаник	ботаник
ботаника	ботаника
ботанье	бурскӧм
боцман	боцман
бочка	бӧчка
боярышник	боярышник
брадобрей	шырсьысь
бракосочетание	гӧтрасьӧм
брасс	брасс
брат	вок
братина	яндӧва
братия	
братия	вокъяс
браунинг	браунинг
бредень	кӧвтым
брезент	брезент
брелок	сыр
бретелька	волыс
бригада	бригада
бригадир	бригадир
бриллиант	бриллиант
бритва	бритва
бровка	дор
бродяга	зимогор
брокер	сёрнитчӧдысь
бром	бром
броненосец	броненосеч
бронепоезд	бронепоезд
бронец	бронеч
брошь	брошка
брызгалка	чилскан
брызганье	прысьмунӧм
брюзгливость	зьваглун
брюква	галанка
брюхо	рушку
брюшко	рушкутор
бугай	ӧш
будильник	будильник
бузина	
бук	бук
бука	иж.разг.
букашка	гаг
буква	шыпас
буквальность	стӧчлун
буквальность	збыльлун
букет	букет
буксировка	кыскӧм
булат	сабля
булыжник	из
бульдог	бульдог
бульдозер	бульдозер
бумеранг	шыбовтас
бунтовщик	бунтуйтысь
бур	писькӧдчан
буржуазия	буржуазия
буржуй	буржуй
бурлачество	бурлакъяс
бутафория	йӧзаддзатор
бутерброд	бутерброд
буфер	
буффонада	теш
бухгалтер	бухгалтер
бухгалтерия	бухгалтерия
бушевание	эралӧм
бушлат	бушлат
былина	былина
быль	вӧвлӧмтор
быльё	турун
бытие	
бюллетень	кабала
бюрократ	бюрократ
бюрократизм	бюрократизм
вага	
вагон	вагон
вагонетка	вагонетка
ваза	ваза
вазелин	вазелин
вакса	вакса
вакцина	вакцина
валет	колоп
валкость	дзибырлун
валок	лёдз
вальдшнеп	мурквечик
вальс	вальс
вальцовщик	вальцуйтчысь
вампир	нярборд
ванилин	ванилин
ванна	ванна
вар	вар
варвар	варвар
варенье	варенньӧ
варка	сывдӧм
василёк	пӧлӧзнича
вассал	вассал
вата	вата
ватага	котыр
ватерпас	ватерпас
ватин	ватин
ватман	ватман
ватт	ватт
вахта	вахта
вахтёр	вахтёр
ваяние	сёртӧм
ваятель	сёртысь
введение	водзкыв
введение	сюйӧм
вгиб	нёптовтчӧмин
вдова	дӧва
вдовец	сьӧп
вдох	лолыштӧм
вдувание	пӧльтӧм
ведомость	ведомосьт
ведомство	ведомство
ведро	ведра
веер	
вездеход	вездеход
везение	мойвиӧм
век	нэм
век	нэм
веко	синлап
вектор	вектор
векша	ур
веление	тшӧктӧм
великодушие	бурлун
величание	ыдждӧдлӧм
величие	
велосипед	велосипед
велоспорт	велоспорт
вельвет	вельвет
велюр	велюр
венец	юртас
веник	корӧсь
венок	юркытш
вентилятор	тӧлӧдчан
вентиляция	тӧлӧдӧм
венчик	сыр
веранда	веранда
верблюд	верблюд
вердикт	помшуӧм
вереница	звӧйк
веретено	чӧрс
верещание	тюрзӧм
вермишель	вермишель
верование	эскӧм
верста	верст
вертлуг	дзулля
вертун	дзирыдпоз
вертун	вабергач
вертушка	
вертушка	
верфь	верфь
верх	болк
верх	эжӧд
верх	бан
верх	верктуй
верх	вылі
верховенство	юрнуӧдӧм
верховод	нырщик
верхоглядство	путьтӧмлун
верша	гымга
вершитель	бергӧдлысь
верёвка	гез
веселье	гажӧдчӧм
вескость	сьӧкталун
вескость	тӧдчанлун
весло	пелыс
весна	тулыс
вест	рытыввыв
вестибюль	водзпом
вестовой	юӧрник
весёлка	мутӧй
ветвь	рӧдвуж
ветвь	юкӧн
ветер	тӧв
ветеран	ветеран
ветерок	тӧвру
ветка	вож
ветла	бадь
ветрило	тӧвдӧра
ветряк	
ветчина	ветчина
вечер	рыт
вечерня	рытъя
вешалка	ӧшӧдан
вешание	вожӧдӧм
вещатель	тун
вещество	вещество
вещь	добра
веяльщик	тӧлӧдчысь
вживление	овмӧдӧм
взбалмошность	путьтӧмлун
взбалтывание	солькйӧдлӧм
взведение	лэптӧм
взвоз	
взморье	саридздор
взрыхление	небзьӧдӧм
взыскание	перйӧм
взятие	босьтӧм
вибрация	сырмӧм
визжание	жиньгӧм
вика	шыранькытш
викинг	руочи
викторина	викторина
вилка	вилки
вилка	вилка
вина	мыж
вина	помка
винегрет	винегрет
вино	вина
винт	винт
винтовка	винтовка
виолончель	виолончель
виселица	рель
висельник	ӧшӧдӧм
висельник	неморт
витамин	витамин
витрина	витрина
вишня	вишня
вклад	чӧжӧс
вклад	пай
владение	тӧдӧм
вливание	кисьтӧм
вливание	сюйӧм
внесение	мынтӧм
внимание	тӧд
вобла	вобла
вода	ва
водолаз	водолаз
водораздел	вапотас
водород	водород
водосток	
воевода	воевода
военачальник	военачальник
военизация	военизируйтӧм
военком	военком
военкомат	военкомат
военкор	военкор
военнообязанный	военнообязаннӧй
военнослужащий	военнӧй
вожак	новлӧдлысь
вождь	вождь
возбудитель	босьтчӧдысь
возбуждение	панӧм
возвеличение	нимӧдӧм
возвышенность	кыпыдлун
возделывание	небзьӧдӧм
воздух	сынӧд
воззвание	шыӧдчӧм
воззрение	видзӧдлас
возмещение	водзӧс
возмужалость	верстьӧлун
возмужание	сӧвмӧм
возраст	арлыд
войлок	гын
вокзал	вокзал
волейбол	волейбол
волок	вӧлӧк
волокно	шуль
волос	си
волосок	ловгӧн
волость	вӧлӧсьт
волчонок	кӧинпи
вольность	кокньӧд
вольт	вольт
вольтметр	вольтметр
вооружение	могмӧдӧм
воркованье	кургӧм
ворон	кырныш
ворона	рака
воронка	воронка
воронка	гу
вороньё	
ворох	вӧрӧк
ворох	чукӧр
ворсинка	ловтор
ворчливость	зьваглун
воскресник	вӧскресник
воскрешение	ловзьӧдӧм
восприемник	вежай
восприемница	вежань
восприимчивость	рыжлун
воспроизводство	мӧдпӧлалӧм
восьмушка	восьмина
восьмёрка	кӧкъямыс
восьмёрка	кӧкъямыса
вошь	той
вояж	путешествуйтӧм
вояка	
впадина	джумгӧр
впайка	спояйтӧм
вправка	веськӧдӧм
вправка	сюйӧм
врачевание	бурдӧдӧм
вращение	бергӧдлӧм
вращение	бергалӧм
вруб	паз
вручение	сетӧм
вручитель	сетысь
вскармливание	вердӧм
вскрик	горӧдӧм
вскрытие	восьтӧм
вскрытие	эрдӧдӧм
вскрытие	воссьӧм
вскрытие	кырлалӧм
вспашка	гӧрӧм
вспрыскивание	пызйӧм
вспышка	ыпнитӧм
вставка	содтӧд
вставка	тув
вступление	пырӧм
всхлип	вишкӧм
всхрап	корснитӧм
всхрапывание	шкоргӧм
втирание	зыралӧм
вторник	воторник
вуаль	вуаль
вулкан	вулкан
вульгаризм	
вход	пырӧм
вхождение	пырӧм
въезд	пырӧм
выбор	бӧрйӧм
выбор	бӧрйӧмтор
выбор	бӧръянтор
выборка	перъялӧм
выборность	бӧрйӧм
выборщик	бӧрйысьысь
выбрасывание	шыблалӧм
выброс	петӧм
выброс	петкӧдӧм
выварка	пуӧм
выведение	петкӧдӧм
выведение	бырӧдӧм
выведение	пӧжӧм
выведение	решитӧм
выверка	прӧверитӧм
выверт	
выверт	чикыльтчылӧм
выверт	чудитчӧм
выветривание	тӧлӧдӧм
выветривание	быгалӧм
вывих	вӧрзьӧм
вывод	петкӧдӧм
вывод	кывкӧртӧд
выводка	бырӧдӧм
выводка	пӧжӧм
выворачивание	песовтӧм
выгонка	
выгонка	вийӧдӧм
выгреб	куралӧм
выделение	петӧм
выделение	тӧдчӧдӧм
выдувка	пӧльтӧм
выдумщик	лӧсьӧдлысь
выдумывание	лӧсьӧдлӧм
выжидание	виччысьӧм
вызволение	мездӧм
выздоровление	бурдӧм
вызов	корӧм
вызов	чукӧс
выкидывание	шыблалӧм
выкипание	пакталӧм
выключение	шыбитӧм
выключение	вӧтлӧм
выключение	кусӧдӧм
выкормыш	
выкраивание	шӧралӧм
выкраивание	вичмӧдӧм
выкрик	горӧдӧм
выкройка	намет
выкуп	вештӧм
выкус	курччалӧмин
вылавливание	куталӧм
выливание	койыштӧм
вылов	кыйӧм
вылов	куталӧм
вылов	шедӧм
вылом	жугӧдӧмин
вымарка	лякӧм
вымарка	киритӧмин
вымачивание	кӧтӧдӧм
вымогание	кӧджӧм
вымогатель	кӧджысь
вымокание	тыасьӧм
вымолачивание	вартӧм
вымолачивание	нӧйтӧм
вымолот	
вымолот	вартӧм
вымолот	усьӧм
вымораживание	кынтӧм
вымочка	кӧтӧдӧм
вымочка	тыӧдӧм
вымочка	бырӧдӧм
вымпел	вымпел
вымысел	вӧвлытӧмтор
вымышленность	лӧсьӧдлӧм
вымя	вӧра
вынашивание	новлӧдлӧм
вынуждение	тшӧктӧм
выпаривание	пӧжӧм
выпас	
выпекание	пӧжалӧм
выпечка	пӧжалӧм
выпивка	
выпиливание	пилитӧм
выпирание	йӧткӧм
выписка	гижӧм
выписка	судзӧдӧм
выплавка	сывдӧм
выпойка	быдтӧм
выпорок	резьӧдӧмтор
выправление	веськӧдӧм
выправление	веськӧдӧм
выпуск	помалысьяс
выпуск	петас
выпушка	дорӧс
выработка	вӧчас
выработка	удж
выравнивание	шыльӧдӧм
выравнивание	веськӧдӧм
выражение	тӧдчӧм
выражение	выраженньӧ
выразительность	серпаслун
вырез	кӧлыс
вырезка	вундӧмтор
вырезывание	вундасьӧм
вырост	быдмӧм
вырубка	кералӧм
вырубка	тшупас
вырывание	нетшкӧм
высадка	пуктӧм
высверливание	розьӧдӧм
высвист	шутьлялӧм
высев	
высев	кӧдзӧм
высев	кӧдзан
выселение	вӧтлӧм
выселок	пӧчинок
высидка	пӧжӧм
выскабливание	гогналӧм
высказывание	мӧвп
выслеживание	туялӧм
выслуга	
выслушивание	кывзӧм
высовывание	мыччалӧм
высокогорье	джуджыдін
высота	ыджда
выставление	пуктӧм
выставление	вӧзйӧм
выступление	кыпӧдчӧм
высь	вылі
вытапливание	сывдӧм
вытаращивание	чашкӧдӧм
вытачка	кызатуй
вытеснение	зырӧм
вытопка	сывдӧм
выточка	дзуртӧм
вытравление	сотӧм
вытравление	тальӧдӧм
вытьё	шутьлялӧм
вытягивание	нюжӧдӧм
вытяжка	кыскӧм
выучка	велӧдӧм
выход	петӧм
выход	петанін
выхолаживание	кӧдзӧдӧм
вычитаемое	чинтан
вычитание	чинтӧм
вычленение	торйӧдӧм
вычурность	тшапитӧм
вышивальщица	вышивайтчысь
вышка	вышка
выя	сьылі
выявление	эрдӧдӧм
выявление	тӧдмалӧм
вьюн	
вьюнок	сиртурун
вьюрок	пинькай
вьюшка	юшка
вяз	сирпу
вязка	кӧлыш
вялость	дыгыдлун
вяхирь	вӧргулю
габардин	габардин
габарит	ыджда
габарит	кост
габаритность	ыдждалун
гавань	ӧзын
гад	пежгаг
гадость	
гадюка	
гаер	сяквар
газация	болльӧдӧм
газета	газет
газовщик	биаруалысь
газолин	газолин
гайка	гайка
гайморит	гайморит
галерея	галерея
галета	галет
галечник	галяиз
галифе	галифе
галка	чавкан
галлюцинация	кажитчӧм
галочка	пас
гантель	гантель
гараж	гараж
гарантия	видзӧм
гардероб	пӧрччысянін
гарем	гӧтыръяс
гармоника	
гармоничность	мылалун
гармоничность	лӧсьыдлун
гармошка	
гармошка	
гарнизон	гарнизон
гарнитур	гарнитур
гастролёр	летун
гастрономия	безмн.ч.
гаубица	гаубича
гашение	кусӧдӧм
гашение	бырӧдӧм
гашение	чинтӧм
гектар	гектар
гелий	гелий
гематома	шаныш
генерал	генерал
генералиссимус	генералиссимус
генерация	кӧлена
гений	енби
гений	орт
географ	географ
география	география
геодезист	геодезист
геолог	геолог
геология	геология
георгин	георгин
гепард	гепард
герань	герань
герб	вужпас
гермафродит	кидӧслун
герметичность	йиджтӧмлун
героизм	героизм
героика	героика
героиня	героиня
герой	герой
герундий	герундий
герцог	герцог
герцогство	герцогув
гетерогенность	сораслун
гибель	
гибкость	лайкыдлун
гибкость	пельклун
гигиеничность	сӧстӧмлун
гидра	гидра
гиена	гиена
гильдия	гильдия
гильза	гильза
гиляк	нивх
гимн	кып
гимназия	гимназия
гимнастёрка	гимнастёрка
гинеколог	гинеколог
гинекология	гинекология
гипербола	
гипотаксис	синӧм
гипотенуза	гипотенуза
гиппопотам	гиппопотам
гипюр	гипюр
гирлянда	гирлянда
гитара	гитара
глагол	кадакыв
гладильня	гладитчанін
гладильщик	гладитчысь
гладиолус	гладиолус
гладкость	шыльыдлун
глаз	син
глазирование	лӧстӧдӧм
глазунья	яеснича
глас	гор
глашатай	йӧзӧдысь
глина	сёй
глинистость	сёйӧдлун
глист	ков
глиста	
глицерин	глицерин
глобус	глобус
глотание	ньылалӧм
глотка	горш
глоток	ньылыштӧм
глупыш	йӧюк
глухарка	кӧндозмӧр
глухота	пельтӧмлун
глушитель	гортӧммӧдысь
глюкоза	глюкоза
гнездование	поздысьӧм
гнездовье	поздысянін
гнида	серов
гниение	сісьмӧм
гнилушка	
гниль	бак
гноение	сісьтӧм
гнёздышко	позтор
говор	сёрниног
говорильня	больганін
гоголь	сювчӧж
гогот	гогзьӧм
год	во
год	арӧс
год	арлыд
година	кад
година	час
гол	гол
голбец	гӧбӧч
голица	кушенча
голова	юр
головка	шляп
головка	йыв
голос	видзӧдлас
голубика	чӧдлач
голубь	гулю
гольд	нанай
гольф	гольф
гомосексуалист	гомосексуалист
гон	чуалӧм
гонка	тэрмасьӧм
гонка	вийӧдӧм
гонщик	ордйысьысь
горбинка	гӧрб
горбушка	мутлак
горбыль	гӧрбыль
горе	
горелка	сотан
горизонт	енэж
горизонт	эрд
горизонт	тӧдӧмлун
горизонт	позянлунъяс
горизонт	куйлӧд
горизонтальность	водсаноглун
горилла	горилла
горлышко	юр
горлянка	чипсантурун
гормон	гормон
город	кар
городьба	
горох	анькытш
горошек	чут
гортензия	гортензия
горчица	горчица
горчичник	горчичник
горшок	гырнич
горячность	ярлун
госимущество	госэмбур
госпиталь	госпиталь
госпожа	ӧксань
гостья	гӧстя
государыня	ӧксань
готовность	дасьлун
грабельщик	куртысь
градирня	градирня
грамзапись	грамгижӧд
грамм	грамм
грамматика	грамматика
граммофон	граммофон
грамота	грамота
граната	граната
гранит	гранит
гранка	гранка
гранулирование	шольгӧмтӧм
грануляция	
грань	этш
граф	граф
графа	визь
графика	графика
графика	шыпасъяс
графин	графин
графиня	графиня
графление	визьйӧдлӧм
графство	графув
гребень	сынан
гребень	печкан
гребень	бурысь
гребля	сынӧм
гребля	куртӧм
гребок	сыныштӧм
гребёнка	гребёнка
грейпфрут	грейпфрут
грех	
грех	грек
гриб	тшак
грива	бурысь
гривна	вежтан
гривна	
грим	грим
гримирование	гримируйтчӧм
грипп	грипп
гроб	горт
гроб	кулӧм
гробница	дзебанін
гром	гым
громкоговоритель	громкоговоритель
громкость	горалун
гроссмейстер	гроссмейстер
грохочение	пожналӧм
грош	грӧш
грубость	вежавидзтӧмлун
грубость	чорыдлун
грудина	морӧспань
грудь	морӧс
груздь	ельдӧг
грунт	муйӧж
грунтовка	
группировка	чукӧр
груша	груша
грыжа	кила
гряда	град
грядка	сёр
грязь	няйт
грёза	вӧт
губернатор	губернатор
губерния	губерния
губка	бӧдяга
губка	губка
гудение	тутсӧм
гудение	брунгӧм
гуж	гужи
гулаг	концлагеръяс
гульбище	гажӧдчанін
гулянка	
гулянка	койташ
гуляш	гуляш
гуманист	гуманист
гурт	стада
гусар	гусар
гусеница	гусенича
гусь	дзодзӧг
гусёнок	дзодзӧгпи
гуща	чукӧраин
давило	тшемилӧ
давило	нальк
давильня	ныранін
давильщик	нырысь
давка	нырӧм
давление	личкӧм
давность	важлун
дар	козин
дарвинизм	дарвинизм
дарвинист	дарвинист
даритель	козьналысь
дарование	сетӧм
даровщинка	
дата	кадпас
датировка	кадпасалӧм
дверца	пӧдан
двигатель	двигатель
движение	мунӧм
движение	ӧтмунӧм
движение	ӧтмунӧм
движок	
двоевластие	кыквласьтдыр
двоение	кыкалӧм
двоеточие	кыкчута
двойка	кык
двойник	орт
двойственность	кыкногалун
дворянин	дворянин
дворянка	дворянка
дворянство	дворяна
двуокись	двуокись
дебитор	уджйӧза
дева	ныв
девиация	
девичество	
девка	ныв
девочка	нывка
девственность	вӧрзьӧдлытӧмлун
девственность	сӧстӧмлун
девушка	ныв
девчонка	нывка
девясил	вижъюр
дежа	шомӧс
дежурка	дежуританін
дежурство	дежуритӧм
действие	уджалӧм
действие	вын
действие	тӧдчӧм
действие	вӧчӧм
действие	арталӧм
действие	лоӧмтор
декабрист	декабрист
декан	декан
декрет	декрет
делегат	делегат
деление	юкӧн
делимое	юклӧг
делитель	юкыш
дело	удж
дело	мог
дело	делӧ
дельтаплан	дельтаплан
дельфин	дельфин
деляга	кӧнӧбой
делячество	кӧнӧбоитчӧм
демобилизация	демобилизуйтӧм
демократ	демократ
демократизм	демократизм
демократия	демократия
демонстрант	демонстрант
демонстрация	демонстрация
демонстрация	петкӧдлӧм
демонстрирование	петкӧдлӧм
денди	тшӧгӧль
денница	
денщик	денщик
день	лун
департамент	департамент
депо	депо
депутат	депутат
деревня	сиктсаяс
деревяшка	
держатель	кутысь
держатель	кутан
дериват	вӧчӧмтор
дерматин	дерматин
дернование	эжаалӧм
дерюга	кеж
десятигранник	дасбока
десятка	даса
десятник	десятник
десяток	дас
детализация	стӧчмӧдӧм
деталь	юкӧн
детектор	
детище	быдтас
детонатор	ышӧдысь
детёныш	пи
дефицит	убытка
деформация	шыгыртчӧм
дециметр	дециметр
дешевизна	донтӧмлун
дешёвка	
деяние	вӧчӧмтор
джаз	джаз
джемпер	джемпер
дзот	дзот
диагональ	диагональ
диаграмма	диаграмма
диалект	сёрнисикас
диалектика	диалектика
диапазон	торъялӧм
диапозитив	диапозитив
диафильм	диафильм
диверсант	диверсант
дивизион	дивизион
дивизия	дивизия
дидактика	
дизель	дизель
дикость	йӧйлун
диктант	диктант
диктатор	диктатор
диктаторство	диктаторалӧм
диктатура	диктатура
диктовка	диктовка
диктовка	тшӧктӧм
диктовка	
диктор	диктор
диморфизм	кыксикаслун
динамика	динамика
динамо	динамо
диплом	диплом
дипломат	дипломат
дипломатия	дипломатия
директор	директор
дирекция	дирекция
дирижёр	дирижёр
диск	пластинка
дисконт	
диспансер	бурдӧдчанін
диспетчер	диспетчер
диспут	вензьӧм
диссидент	
дистанция	туйкост
длань	ки
длина	кузьта
длительность	кузьта
днёвка	лунйӧм
добавка	содтӧд
добавление	содтӧд
доблесть	
доблесть	повтӧмлун
доброта	бурлун
доброхот	
доброхот	
доброхот	
добывание	перйӧм
добывание	кыйӧм
добытчик	перйысь
добыча	перйӧм
добыча	шедас
доведение	вайӧдӧм
доверенность	эсканпас
довод	подув
довольство	дӧвӧльлун
догадка	чайтӧм
догляд	дӧзьӧр
договор	сёрнитчӧм
дозиметр	дозиметр
дозирование	юклӧм
дозировщик	юклысь
дозор	видзӧдысь
дозревание	кисьмӧм
дойник	пӧдӧнча
док	док
доказательство	эскӧдӧм
доказательство	докажитӧм
доклад	доклад
доктор	доктор
докучливость	дӧзмӧдчӧм
дол	эрдвыв
долбление	дӧжналӧм
долбление	зубритӧм
долгоденствие	дырлун
долгота	кузьта
долгота	кузьтӧс
долдон	мӧмӧт
должность	чин
доллар	доллар
доломит	доломит
долото	ӧжын
доля	юкӧн
доля	пай
дом	керка
дом	горт
дом	семья
доменщик	домнадорса
домкрат	домкрат
домна	домна
домовитость	идӧрлун
домохозяин	юркутысь
домохозяин	
домохозяйка	юркутысь
домохозяйка	месань
домра	домра
донесение	юӧр
донесение	соритӧм
донник	тӧзь
дополнение	содтӧм
дополнение	содтӧд
допрос	юасьӧм
дорога	туй
дорожка	кыснан
досада	
досада	забеднӧ
доска	пӧв
досмотр	дӧзьӧр
досмотр	видлалӧм
достаток	тырманлун
достаточность	тырманлун
достаточность	судзӧг
доступ	пырӧм
доступность	сибаланлун
дот	дот
доцент	доцент
доцентура	доцентъяс
дочь	ныв
дояр	лысьтысьысь
драгоценность	донатор
дракон	гундыр
драма	драма
драматизм	драматизм
драматург	драматург
драматургия	драматургия
драмкружок	драмкружок
драп	драп
драпировка	занавес
дребедень	
дребедень	ковтӧмтор
древность	важлун
древостой	вӧр
древоточец	пучӧй
дрезина	дрезина
дрейф	
дробовик	дрӧбӧвик
дровосек	сиргаг
дрозд	пелыськай
дрянь	
дрянь	
дряхлость	пӧрысьлун
дуб	тупу
дубильня	дубитчанін
дублирование	мӧдпӧлалӧм
дубль	
дубьё	
дуга	мегыр
дуга	кӧнов
дужка	вуг
дуля	чирук
дупло	розь
дура	йӧй
дурман	кольмӧдантурун
дурман	бӧбйӧдлантор
дуст	дуст
дутьё	пӧльтӧм
духовник	висьӧдысь
духовность	ловлун
душ	душ
душа	лов
душа	сьӧлӧмшӧр
душок	
душок	дук
душок	ру
дуэль	дуэль
дым	тшын
дымка	ру
дыня	дыня
дыра	розь
дьяк	
дьякон	дякӧн
дюймовка	
дядя	дядь
дятел	сизь
дёготь	дьӧгӧдь
дёгтемаз	суклясьысь
дёрн	эжа
евровалюта	евровалюта
еда	сёйӧм
единогласие	ӧтсӧглас
единодушие	ӧтсӧглас
единообразие	ӧткодьлун
единство	ӧтувъялун
единство	ӧтторъялун
едок	сёйысь
ежевика	ежевика
ежонок	ёжпи
ездок	верзьӧма
ездок	ветлысь
елец	мык
ендова	яндӧва
енот	енот
епископ	аркирей
ерунда	
ефрейтор	ефрейтор
ехидна	ехидна
ехидство	лӧглун
ехидство	бытшласьӧм
жабник	куимвужъятурун
жакет	жакет
жало	чушкан
жалобщик	норасьысь
жалованье	удждон
жандарм	жандарм
жар	ӧгыр
жар	пӧсь
жаргон	жаргон
жасмин	жасмин
жатва	вундан
жгут	гартӧд
жгут	кӧртӧд
жезл	бедь
желательность	коланлун
желатин	желатин
железнение	кӧртмӧдӧм
железо	кӧрт
жеманность	тшаплун
жемчужина	озырлун
женитьба	гӧтрасьӧм
жених	верӧспу
женьшень	женьшень
жеребец	уж
жертва	вись
жесть	жӧч
жестянка	жӧчтор
жетон	пастор
живодёр	
живодёрня	начкысянін
живопись	серпасъяс
живость	ясыдлун
живость	кыпыдлун
животное	пемӧс
живучесть	винёвлун
живчик	
жидкость	кизьӧртор
жижа	ва
жизнедеятельность	олӧм
жизнь	олӧм
жилет	жилет
жилетка	жилетка
жилец	олысь
жилка	визь
жираф	жираф
житель	олысь
жительство	олӧм
житие	олӧм
житница	няняин
житьё	олӧм
жнец	вундысь
жнивьё	идза
жом	жӧм
жом	пыдзрас
жрец	тун
жулик	жулик
жульничество	жульничайтӧм
жупел	повзьӧдчан
журнал	журнал
журнал	луннебӧг
журналист	журналист
жуть	
жёлчность	лӧглун
жёлчь	лӧг
жёрдочка	сёр
жёрнов	изки
забастовка	забастовка
забастовщик	бастуйтысь
забвение	вунӧдӧм
забег	котӧртӧм
забивка	тувъялӧм
забивка	тупкӧм
заблуждение	ылалӧм
заболонь	болонь
забота	мог
заброс	
забывчивость	вунӧдчӧм
завалинка	мудӧд
заварка	заваритӧм
заварка	заваритан
заведение	заведенньӧ
заведование	веськӧдлӧм
заведующий	веськӧдлысь
заверение	эскӧдӧм
заверитель	эскӧдысь
заветность	гусялун
завивка	кудри
завиток	гӧрддзым
завоз	вайӧм
заворот	
заворот	чукыль
завывание	омлялӧм
завёртка	гартӧд
загадывание	нӧдӧм
загадывание	туналӧм
загазованность	няйтӧссьӧм
загвоздка	мытшӧд
загиб	кежӧм
заглатывание	ньылыштӧм
загнетка	кунлӧс
загородка	
загородка	вежӧс
заграница	суйӧрсай
загс	загс
загустение	тшӧкмӧм
загуститель	сукмӧдантор
зад	бӧр
задавленность	дзескӧдӧм
задача	мог
задача	задача
задачник	задачник
задвижка	юшка
задержание	кутӧм
задок	
задолженность	уджйӧз
заезд	воӧм
заезд	кежалӧм
зажатие	тупкӧм
зажигалка	ӧзтан
заикание	мыкталӧм
заиление	нюйтӧссьӧм
зайчик	кӧчиль
зайчик	кӧч
зайчик	пужъялӧмин
зайчонок	кӧчпи
закавычка	
закавычка	
закал	донӧдӧм
закалка	винёвлун
закалывание	начкӧм
закат	рытыввыв
закатка	шыльӧдӧм
заклад	заклад
заклеивание	лемалӧм
заклинание	кевмысьӧм
заклинание	нимкыв
заключение	пукалӧм
заключение	вӧчӧм
заключение	кывкӧртӧд
заключённый	пукалысь
заклёпка	
заклёпка	клепайтӧм
заколка	пажук
закон	этш
законник	
законность	оланпаслун
законченность	помасьӧм
закорючка	
закорючка	мытшӧд
закоулок	кулига
закраина	дорва
закрепитель	кутчӧг
закройка	шӧралӧм
закройщик	шӧрасьысь
закром	йӧртӧд
закупщик	ньӧбалысь
закуска	закуска
закусочная	нуръясянін
заледенение	йизьӧм
заледенение	гегдӧм
залесье	вӧрсай
залив	куръя
залом	пором
залом	чегӧмин
залп	залп
замазка	тупкӧм
замазывание	тупкӧм
замачивание	кӧтӧдӧм
замачивание	тыӧдӧм
замена	вежӧм
заменитель	вежысь
замерзание	кынмӧм
замес	кӧтӧм
заместитель	вежысь
заместительство	вежӧм
заметка	пас
заметка	пасйӧд
замещение	вежӧм
замкнутость	вӧйлун
замораживание	кынтӧм
замша	няр
занавес	занавес
занавеска	занавес
заначка	
заначка	дзебӧмин
заначка	дзебӧмтор
занижение	чинтӧм
занудливость	дӧзмӧдчанлун
занятие	удж
занятость	
заострение	тӧдчӧдӧм
заострённость	ёсьлун
запайка	спояйтӧм
запаривание	пӧжӧм
запашка	
запашка	гӧрӧм
запашка	му
запашник	гӧр
запевала	иж.
запевала	босьталысь
запевала	нырщик
запеканка	запеканка
записка	гижӧд
записка	гижӧдтор
запись	гижӧд
заповедник	заповедник
заповедь	тшӧктӧм
заправка	сюялӧм
заправка	панӧм
заправка	лӧсьӧдӧм
запрос	шыӧдчӧм
запустение	эндӧм
запустение	эжмӧдӧм
запятая	чутік
заработок	удждон
зарево	югӧр
зародыш	пытшпи
зарождение	иперен.
зарплата	удждон
зарубежье	суйӧрсай
заря	кыа
заря	заводитчӧм
заряд	зарад
зарядка	зарядка
засада	кыйӧдчанін
засада	кыйӧдчысьяс
засвидетельствование	эскӧдӧм
засев	кӧдзӧм
заседание	заседанньӧ
заседатель	заседатель
заселённость	овмӧдчӧм
засилье	ыджыдалӧм
заскок	тешкодьлун
заслон	сайӧд
заслон	пемдӧд
засмолка	сиралӧм
засол	солалӧм
засоление	соласьӧм
засольщик	соласьысь
засос	кыскӧм
застолье	
застройка	стрӧитчӧм
застройщик	стрӧитчысь
заступник	дорйысь
застёжка	йитвеж
засушка	косьтӧм
засыпание	унмовсьӧм
засыпка	шӧтӧм
засыпка	кисьтӧм
засыхание	косьмӧм
затверделость	чорыдлун
затвердение	чорзьӧм
затвор	иган
затейливость	тшапитӧм
затейливость	гажӧдӧм
затейливость	тешкодьлун
затейник	ворсӧдысь
затмение	бердлӧм
затон	полой
затор	мытшӧд
затрата	видзӧм
затрата	рӧскод
затребование	корӧм
затруднение	сьӧкыдлун
затяжка	зэлӧдӧм
затяжка	кыскӧм
заулок	уличкост
заутреня	асъя
заучивание	велӧдӧм
захват	
захватчик	мырддьысь
заход	пырӧм
заход	кежалӧм
зацепка	крук
зачин	пансьӧг
зачин	панас
защипка	чепльӧс
защипка	доралӧм
защита	дорйӧг
защита	дорйысьяс
защита	дзебсьӧм
заявитель	
заявитель	шыӧдчысь
заявитель	корысь
заявка	юӧртӧм
заявление	шыӧдчӧм
заяц	кӧч
звание	ним
звание	чин
звезда	кодзув
звено	прасла
звено	тшытш
звено	звено
звонница	звӧннича
звонок	звӧнок
звук	шы
здоровье	дзоньвидзалун
здравпункт	бурдӧдчанін
зеванье	очсалӧм
зеванье	дзӧръялӧм
зелень	
зелье	зелля
зелье	порок
земля	му
земляника	оз
земство	земство
зенитка	зенитка
зенитчик	зенитчик
зеница	син
зерно	тусь
зерно	чир
зима	тӧв
зимование	тӧвйӧм
зимовка	тӧвйӧм
зимовка	тӧвъянін
зимовщик	тӧвйысь
зимовье	тӧвъянін
зимородок	висвывкай
зипун	дукӧс
злато	зарни
злободневность	медколанлун
знак	пас
знакомство	тӧдмасьӧм
знакомство	тӧдсаяс
знаменатель	юклӧд
знание	тӧдӧм
знаток	тӧдысь
значение	вежӧртас
значение	тӧдчанлун
значимость	тӧдчанлун
значок	пас
значок	пасйӧд
зов	корӧм
зола	пӧим
золовка	аяныв
золото	зарни
золотуха	зӧлӧтука
золочение	зарниалӧм
зольник	
зомбирование	тӧдчӧм
зонд	зонд
зонт	лэб
зоолог	зоолог
зоология	зоология
зоопарк	зоопарк
зоотехник	зоотехник
зоркость	сюсьлун
зорька	кыа
зрелость	верстьӧлун
зритель	видзӧдысь
зубец	пинь
зубило	зубилӧ
зубр	зубр
зубрёжка	зубритӧм
зуд	телепит
зыбь	гы
зычность	горалун
зюзя	иж.прост.
зюйд	
зяблик	пинькай
зять	зять
иволга	дзулимкай
игла	ем
игла	лыс
иго	
иго	сьӧктӧд
игра	ворсӧм
игра	ворсантор
игрок	ворсысь
идеализм	идеализм
идеалист	идеалист
идентитет	асвежӧртӧм
идентификация	ӧткодялӧм
идентичность	ӧткодьлун
идея	тырмӧвп
идиоматика	
идол	бӧлбан
иерей	поп
изба	керка
избалованность	дрӧчитӧм
избиение	нӧйтӧм
избиратель	бӧрйысьысь
избрание	бӧрйӧм
извержение	вӧтлӧм
известие	юӧр
известкование	коризалӧм
известняк	кориз
извив	чукыль
извилина	сёртас
извлечение	цитата
изворотливость	наянлун
изгиб	чукыль
изгиб	муткыр
изголовье	юрув
издание	лэдзӧм
издатель	лэдзысь
издательство	лэдзанін
изжитие	бырӧдӧм
излечение	бурдӧм
изложение	изложенньӧ
излом	муткыр
измельчание	посняммӧм
измельчание	ляпкалӧм
измельчение	шырӧм
измена	вузалӧм
измена	пӧръялӧм
изменчивость	вежласьӧм
изменяемость	вежласьӧм
измеритель	мурталысь
измеритель	муртӧг
изнанка	гуг
изнасилование	мырдӧналӧм
изнашивание	важмӧм
износостойкость	изсьытӧмлун
изношенность	киссьӧм
изоляция	эжӧд
изостудия	изостудия
изохронность	ӧтдыралун
изощрение	наянлун
изречение	
изречение	шуӧм
изъязвление	ордӧдӧм
изъян	порот
изъяснение	висьталӧм
изъятие	
изысканность	мичлун
изысканность	чиглун
изюм	изюм
икона	ӧбраз
ил	нюйт
иллюстрация	серпас
ильм	сирпу
император	император
императрица	императрича
империализм	империализм
империалист	империалист
империя	империя
импичмент	эскытӧм
импичмент	мыжалӧм
имя	ним
имя	нималӧм
имярек	
имярек	кодкӧ
инвариантность	вежсьытӧмлун
индекс	индӧс
индифферентность	веськодьлун
индукция	индукция
индустрия	индустрия
индюк	индюк
инженер	инженер
инициативность	водзмӧстчанлун
инновация	выльпыртӧм
инок	манак
инокиня	манакиня
иносказание	нӧдӧм
инсинуатор	суклясьысь
инсинуация	суклясьӧм
инспектор	инспектор
инспекция	
инспекция	
инспекция	инспекция
инспиратор	ызйӧдысь
инспирация	апыштӧм
институт	институт
инструкция	чуйдӧс
инструкция	индӧд
инсценировка	ворсантор
интеграл	интеграл
интеграция	интеграция
интеллигент	интеллигент
интенсивность	ёнлун
интервент	интервент
интернат	интернат
интернационал	интернационал
интернационалист	интернационалист
интерпретатор	гӧгӧрвоӧдысь
интерпретация	гӧгӧрвоӧдӧм
интоксикация	пагалӧм
инфлюэнца	грипп
информация	тӧдмӧдӧм
информация	юӧр
инфузория	инфузория
ипостась	этш
искание	корсьӧм
искатель	корсьысь
искатель	бӧрйысь
исключение	кежӧм
искренность	веськыдлун
искусство	искусство
испаряемость	пакталӧм
исповедальня	висьтӧданін
исповедание	
исповедание	эскӧм
исповедник	висьтасьысь
исповедь	висьтасьӧм
исполин	
исправник	исправник
испражнение	асмогасьӧм
испытание	экзамен
испытание	сьӧкыдлун
истерия	
истечение	петӧм
исток	йыв
историзм	историзм
историк	историк
источник	ӧшмӧс
источник	сетысь
истребитель	истребитель
исус	исус
исхудалость	шеньӧблун
исцеление	
итог	ӧтвывтӧм
ишак	осёл
ишемия	ишемия
ищейка	шпион
йог	йог
йогурт	юмйӧв
йод	йод
йодоформ	йодоформ
кабак	кабак
кабан	вӧрпорсь
кабель	кабель
кабина	кабина
кавалерист	кавалерист
кадр	кадр
кадриль	шен
казак	казак
казарма	казарма
казеин	казеин
каземат	каземат
казинет	казинет
казна	казна
казначеи	казначей
казначейство	казначейство
казуист	
казуистика	
какао	какао
кактус	кактус
каланча	каланча
калач	кӧлач
калейдоскоп	калейдоскоп
календарь	лунпас
калий	калий
калина	
калина	жовпу
калитка	дзиръя
калорийность	ӧдъялун
калорийность	окталун
кальмар	кальмар
кальций	кальций
кальян	каллян
камас	камыс
камбала	пӧвтан
камбий	ли
каменка	гор
камень	из
камень	шог
камин	камин
камланье	туналӧм
каморка	чулан
кампания	кампания
камуфляж	ылӧдӧм
камфара	камфара
камыс	кыс
канал	канал
канализация	канализация
канарейка	канаркай
канва	канва
канделябр	пеша
канистра	канистра
канительщик	зуньӧ
канифоль	канифоль
каннибал	
каннибализм	
кант	дорыш
канцеллинг	бырӧдӧм
канцелярия	канцелярия
каолин	каолин
капелла	капелла
капилляр	вирсі
капитал	капитал
капитализация	капитализируйтӧм
капитализм	капитализм
капиталист	капиталист
капитан	капитан
капитулянт	сетчысь
капитулянтство	сетчӧм
капитуляция	сетчӧм
капкан	капкан
капонир	
капрон	капрон
капсула	йӧртӧс
капсюль	пистон
карабканье	кавшасьӧм
караван	караван
каракуль	каракуль
карандаш	карандаш
карась	гыч
каратель	мыжалысь
караул	караул
караул	
караул	караул
карбамид	кудзва
карбюратор	карбюратор
каре	
карета	карета
каретка	вешльӧс
каркас	ыв
карлик	карлик
карман	зеп
карнавал	карнавал
карниз	карниз
карп	карп
карта	карті
карта	небӧгтор
картечь	картеч
картина	кино
картон	картон
картон	кӧрӧбка
картофель	картупель
карточка	карточка
картошка	картупель
картуз	картуз
картёж	картіасьӧм
картёжник	картіасьысь
карусель	карусель
карцер	чижовка
карьера	удж
касатка	чикыш
каска	каска
каскадёр	каскадёр
касса	касса
кассета	кассета
кассир	кассир
кастет	кастет
кастратор	кодзсьысь
катавасия	сьылӧм
катавасия	суматока
каталог	каталог
катание	исласьӧм
катание	ветлӧм
катар	мылӧд
катастрофа	торксьӧм
катафалк	катафалк
категоричность	чорыдлун
катер	катер
катет	катет
катод	катод
католик	католик
католичество	католичество
каторга	катарга
каторжанин	катаргаса
катушка	трубича
катыш	
каузальность	помкалун
каучук	каучук
кафе	кафе
кафедра	кафедра
кафель	кафель
кафетерий	кафетерий
кафтан	дукӧс
качание	довкйӧдлӧм
качание	шатлӧдлӧм
качание	лэптӧм
качание	качайтчӧм
качество	ногтуй
каша	рок
кашевар	пусьысь
кашемир	кашемир
кашка	бобӧнянь
кашлюн	кызысь
каштан	каштан
каюта	каюта
квадратура	квадратура
квакша	гоглач
квалификация	уджсикас
квартал	квартал
квартет	квартет
кварц	кварц
квас	ырӧш
квитанция	квитанция
квота	пай
квотирование	юклӧм
кедровка	перк
кекс	кекс
келья	келля
кенгуру	кенгуру
керамзит	керамзит
керосин	карасин
кета	кета
кетчуп	кетчуп
кефир	шомйӧв
кибернетика	кибернетика
кидание	койӧм
кила	йог
киловатт	киловатт
килограмм	килограмм
километр	километр
киль	коя
килька	килька
кинематика	кинематика
кинематограф	кинематограф
кинематография	кинематография
кинжал	кинжал
кино	
кино	
кино	
киноактриса	киноактриса
киноактёр	киноактёр
киноаппаратура	киноаппаратура
киножурнал	киножурнал
кинооператор	кинооператор
киноплёнка	киноплёнка
кинопрокат	кинопрокат
кинопромышленность	кинопромышленносьт
кинорежиссёр	кинорежиссёр
киносказка	киномойд
киностудия	киностудия
кинотеатр	кинотеатр
кинофестиваль	кинофестиваль
кинофильм	кинофильм
кинохроника	кинохроника
кипа	чукӧр
кипа	тюк
кипарис	кипарис
кираса	
кирза	кирза
кисель	рок
кисет	кӧшель
киска	кысук
кислица	шомкор
кислород	кислород
кислота	шом
кислотность	томлун
кислятина	
кисть	туг
кисть	роз
кит	кит
китель	китель
кишечник	сюв
кишка	сюв
кишка	шланг
клавесин	клавесин
клавиатура	поньтӧдъяс
клавиш	поньтӧд
клад	клад
кладезь	ӧшмӧс
кладка	вайӧм
кладка	тэчас
кладовка	чулан
кладчик	тэчысь
кларнет	кларнет
класс	класс
класс	тшупӧд
классик	классик
клевер	бобӧнянь
клей	лем
клеймо	чокан
клейстер	клестер
клекот	турзӧм
клепание	клепайтӧм
клетка	клетка
клетка	жыр
клетка	кар
клетчатка	клетчатка
клеть	жыр
клеёнка	клеёнка
клизма	клизма
климакс	климакс
климатолог	климатолог
клин	тув
клин	кокад
клиника	клиника
клич	горӧдӧм
кличка	ним
клише	
клише	клише
клозет	асмогасянін
клок	тылым
клоп	лудік
клубок	тупыль
клубок	чакыль
клумба	клумба
клык	водзир
клык	урпинь
клюв	ныр
клюква	турипув
ключица	
ключица	вотшлы
клякса	лякӧс
кляп	калябеч
кляузник	суклясьысь
кляча	вӧвшой
клёв	босьтӧм
клён	клён
клёпка	
клёпка	клепайтӧм
клёш	клёш
кнопка	кизь
кнут	орс
княжение	ӧксыалӧм
княженика	
княженика	сьӧлаоз
княжество	ӧксыув
коагуляция	
коагуляция	едмӧм
коагуляция	чорзьӧм
коалиция	ӧтувтчӧм
кобура	пуртӧс
кобыла	кӧбыла
коваль	дорччысь
ковка	дорӧм
ковка	дорччӧм
ковчег	куд
ковёр	ковёр
код	код
кодирование	кодируйтӧм
кодировщик	кодируйтысь
кожух	пась
коза	кӧза
козлёнок	кӧзапи
козон	шег
козырь	кӧзыр
козырёк	лэб
козёл	кокша
койка	койка
койне	койне
коклюшка	дзоль
кокора	вужля
кокс	кокс
коксование	коксуйтӧм
колба	колба
колбаса	калбас
колдобина	
колдовство	кидтысьӧм
колдун	смилитчысь
колебание	вежласьӧм
коленкор	калинкор
колено	пидзӧс
колено	юкӧн
колено	виччысьтӧмтор
колер	рӧм
колировка	бурмӧдӧм
колледж	колледж
коллективизация	ӧтувтӧм
коллективизм	ӧтувлун
коллективность	ӧтувъялун
коллективность	чукӧралун
коловращение	
коловращение	вабергач
колодка	юр
колодка	тас
колокол	жыннян
колокольня	кӧлӧкӧльнича
колониализм	колониализм
колония	колония
колос	шеп
колосс	
колотушка	тотшкӧдчан
колотушка	мыжык
колхоз	колхоз
колыбель	чужанін
колыхание	едъялӧм
кольраби	кольраби
кольцевание	
кольцо	чунькытш
кольцо	чикыль
кольцо	кольча
коляска	коляска
команда	команда
команда	котыр
команда	веськӧдлӧм
командир	командир
командировка	командировка
командование	веськӧдлӧм
командование	веськӧдлысьяс
комар	ном
комарник	кукыль
комбайн	комбайн
комбайнёр	комбайнёр
комбикорм	комбикӧрым
комбинат	комбинат
комбинация	мутлуйтчӧм
комбинезон	комбинезон
комендант	комендант
комендатура	комендатура
комиссар	комиссар
комиссариат	комиссариат
комитет	комитет
комичность	тешкодьлун
комментирование	гӧгӧрвоӧдӧм
коммуна	коммуна
коммунизм	коммунизм
коммуникация	туйяс
коммунист	коммунист
коммутатор	коммутатор
комод	камод
комок	
компактность	топыдлун
компаньон	ёрт
компетенция	
комплектация	чукӧртӧм
композиция	тэчас
компот	компот
компрессия	топӧдӧм
компьютер	компьютер
комсомол	комсомол
комсомолец	комсомолеч
комсомолка	комсомолка
комсорг	комсорг
конвейер	конвейер
конверт	конверт
конвой	конвой
конгломерат	ӧтгудыр
конгруэнтность	ӧткодьлун
конденсация	
кондитер	кондитер
кондиция	
кондуктор	кондуктор
конец	пом
конец	йыв
конец	пома
конкретность	стӧчлун
конкурс	конкурс
конопатка	сюялӧм
конопля	пыш
коноплянка	пышкай
консалтинг	туйдӧдӧм
консервант	консервант
консерватория	консерватория
консервирование	консервируйтӧм
консигнация	
консистенция	суклун
консонанс	мылалун
конспект	конспект
конспектирование	конспектируйтӧм
консул	консул
консульство	консульство
контейнер	контейнер
контекст	контекст
контингент	урчитӧм
континент	континент
контора	контора
контрабанда	
контрабас	контрабас
контрактация	
контроль	контроль
контроль	ыджыдлун
контрреволюционер	контрреволюционер
конус	конус
конференция	конференция
конфета	кампет
конфискация	мырддьӧм
конфорка	кампорка
конфуз	мугыр
концентрация	озырмӧдӧм
концепция	
концерт	концерт
концессия	
концлагерь	концлагер
кончина	кувсьӧм
конъектура	чайтӧм
конь	вӧв
конь	кокша
коньяк	коньяк
конюх	конюк
конёк	ӧклупень
кооператив	кооператив
кооператив	вузасянін
кооперация	кооперация
кооперация	вузасянін
координата	координат
координата	оланін
копирование	копируйтӧм
копировщик	копируйтчысь
копия	копия
копка	перйӧм
копка	корсьӧм
копна	юр
копна	порсь
коптилка	дзузган
коптилка	
коптильня	тшынӧдчанін
коптильщик	тшынӧдчысь
копуляция	ӧтлаасьӧм
копчение	тшынӧдӧм
копчик	виклеч
копыто	гыж
копьё	шы
кора	кырсь
корабль	караб
коралл	коралл
кордон	су
коренастость	латшкӧслун
корень	вуж
корень	вуж
корень	подув
коржик	коржик
корзина	кӧрзина
корзинка	кӧрзинка
коридор	коридор
корка	кыш
корка	корка
корм	вердӧм
корма	бӧж
кормилица	
кормилица	нёньӧдчысь
кормило	
кормление	нёньӧдӧм
кормчий	бӧжалысь
кормёжка	вердчанін
короб	
коробочка	поз
короед	пучӧй
королева	ферзь
королевство	королевство
король	король
король	туз
коромысло	карнан
коромысло	жаравеч
корона	юртас
коронование	юртасалӧм
короткость	дженьыдлун
корпус	чукӧр
корреспондент	корреспондент
корреспонденция	письмӧяс
кортеж	кортеж
корчага	гырнич
коршун	варыш
корысть	горшлун
корыто	вор
корь	ляті
коряга	вужля
косеканс	косеканс
косец	ытшкысь
косинус	косинус
косица	
косметика	мичмӧдчӧм
космонавт	космонавт
космос	космос
косолапость	укшальлун
костра	сюв
костыль	кӧстыль
костыль	тув
кость	моль
костюм	костюм
костюм	паськӧм
костяк	лысьӧм
костяника	намыр
костяшка	
котангенс	котангенс
котелок	юр
котенок	каньпи
котик	
котлета	котлет
котёл	пӧрт
кофта	ковта
кочегарка	ломтысянін
кочка	вутш
кошева	кӧшӧва
кошель	кӧшель
кошенина	
кошенина	вӧвдӧм
кошенина	
кошмар	
кошт	кошта
кошёлка	кӧрзина
кощей	кощей
кощей	скупердяй
кощунство	смекайтчӧм
коэффициент	коэффициент
краешек	
краешек	дорйыв
край	ин
край	край
крапива	петшӧр
крапивник	петшӧраин
крапивница	наля
крапина	чут
красавец	мича
красавица	мича
красильня	мичӧдчанін
красильщик	мичӧдчысь
красноармеец	красноармееч
краснофлотец	краснофлотеч
краснуха	наля
красота	
красочность	яръюгыдлун
краткость	дженьыдлун
кратность	юксьӧм
кратность	пӧвсталун
крах	пасьмунӧм
крахмаление	крахмалитӧм
кредо	
крейсер	крейсер
крекинг	
крем	крем
кремень	скупердяй
кремнезём	кремнезём
крен	кежӧм
крендель	
крепдешин	крепдешин
крепёж	кутӧд
кресало	тывкӧрт
кресло	креслӧ
крест	пернапас
крест	
крест	крестӧн
крестик	пас
кречет	варыш
крещение	
кривда	лӧж
крикун	
критицизм	
кровать	крӧвать
кровельщик	вевттьысьысь
кровля	вевт
кровоподтёк	шаныш
кровоточивость	
кровь	сям
кроение	шӧралӧм
крокодил	крокодил
кролик	кролик
крольчонок	кроликпи
кромка	дор
кромка	дорыш
кропильница	
кропильница	
крот	
кротость	рамлун
крохаль	косысь
крошечка	
кругляк	
кругооборот	бергӧдчӧм
кружево	прӧшви
кружка	кружка
кружок	кружок
круиз	круиз
крупа	шыдӧс
крупа	катшашыдӧс
крупинка	чир
крупинка	войт
крупность	ыджда
крутогор	кыркӧтш
крутость	зӧмлун
кручина	шог
крушина	ошсэтӧр
крушинник	ошсэтӧраин
крыжовник	крыжовник
крыло	борд
крыло	бок
крыло	юкӧн
крыльцо	кильчӧ
крыса	крыса
крысёнок	крысапи
крыша	вевт
крышка	
крюк	крук
крючкотвор	дзугысь
крючкотворство	дзугӧм
крючок	крук
крючок	вугыр
крючок	крючок
крючок	калич
кряж	нӧрыс
кряканье	ыксӧм
кряква	горда
ксенофобия	
ксерография	ксерография
ксерокопия	ксерокопия
ксерокс	ксерокс
куафёр	шырсьысь
кубатура	ыджда
кубок	кубок
кубометр	кубометр
кувшин	кувшин
кузнец	дорччысь
кузница	доранін
кузов	кузов
кукареканье	чуксасьӧм
кукла	акань
кукуруза	кукуруза
кукушка	кӧк
кукушонок	кӧкпи
кукша	кеня
кулачество	кулакъяс
кулачьё	кулакъяс
кулебяка	черинянь
кулик	витульган
кулинария	кулинария
кулинария	сёян
культиватор	культиватор
культивирование	
культпоход	культпоход
культура	культура
кулёк	кулёк
кум	кум
кума	кума
кумач	кумач
кумирня	кевмысянін
кумовство	кумасьӧм
кумовство	пӧтачка
кумушка	суклясьысь
куница	тулан
купальница	купальнича
купальщик	купайтчысь
купание	купайтӧм
купе	купе
купец	купеч
купечество	купечьяс
куплет	куплет
купорос	купорос
кур	петук
кура	курӧг
кураж	
курган	мыльк
курево	
курево	тшынасян
курево	тшынас
курево	ру
курень	чом
курилка	куритчанін
курильщик	куритчысь
курок	курӧк
куропатка	байдӧг
курорт	курорт
курпей	
курс	курс
курсив	курсив
куртка	куртка
куртье	сёрнитчӧдысь
курчавость	читкыльлун
курьёзность	тешкодьлун
кусок	торпыриг
кусок	пома
кусок	юкӧн
кусок	пельӧс
куст	куст
кустарник	куст
кустарничество	вӧчасьӧм
кустарщина	
кутила	юысь
кутузка	дзескыдін
кутёнок	кычи
кухня	сёян
лабаз	кум
лабаз	лэбув
лабаз	тшамъя
лаборант	лаборант
лаборантка	лаборантка
лаванда	лаванда
лавина	
лавина	люзьгӧмӧн
лавочник	
лавочница	
лавр	лавр
лаг	
лагерь	лагер
лазутчик	разведчик
лайнер	лайнер
лак	лак
лакей	лакей
лакейство	лакеялӧм
лакировка	лак
лакмус	лакмус
лаконизм	дженьыдлун
лактация	лысьтандыр
лактация	нёньӧдчандыр
лампа	лампа
лампада	би
ландыш	ландыш
лапа	ки
лапа	лапа
лапотник	
лапоть	нинкӧм
лапта	
лапушка	
лапчатка	куимвужъятурун
лапша	лапша
ларь	йӧртӧд
ларь	
ларёк	вузасянін
ласковость	мелілун
ласточка	чикыш
лауреат	лауреат
лафет	подув
лачуга	керкашой
лгун	пӧръяч
лгунья	пӧръячка
лебеда	пӧттурун
лебедь	юсь
легион	легион
легитимация	
легкоатлет	легкоатлет
легкомысленность	кокнилун
лежание	куйлӧм
лежанка	куйланін
лежбище	куйлас
лежень	
лейборист	лейборист
лейкопластырь	лейкопластыр
лейтенант	лейтенант
лейтмотив	сюрӧс
лекарь	бурдӧдысь
лексема	торъякыв
лексика	кыввор
лексикон	кывчукӧр
лексикон	кыввор
лекция	лекция
лемма	лемма
ленивость	дышлун
лень	дыш
леопард	леопард
лепесток	сыр
лепетун	
лепетун	бызгун
лепёшка	лапӧ
лесенка	
лесина	
лесистость	вӧраин
лесонасаждение	
лесонасаждение	обычномн.ч.
лесопарк	вӧрпарк
лесопункт	вӧрпункт
леспромхоз	вӧрпромхоз
лесхоз	лесхоз
летание	лэбалӧм
лето	гожӧм
летун	
летун	палюр
летучесть	лэбаланлун
летучка	собрание
летучка	
лещ	ёді
лиана	лиана
либерал	либерал
либерализм	либерализм
либретто	
лидер	юрнуӧдысь
лизание	нюлӧм
лизание	нювсьӧм
ликвидатор	бырӧдысь
ликвидность	инанлун
ликование	радлӧм
ликоподий	кӧчвӧнь
ликёр	ликёр
лилия	запанки
лимон	лимон
лимфа	сӧз
линия	вежтас
линия	нырвизь
линкор	линкор
линование	визьйӧдлӧм
линовка	визьйӧдлӧм
линолеум	линолеум
линотип	линотип
линь	линь
лирик	лирик
листовка	листовка
листок	
лисёнок	ручпи
литера	шыпас
литота	ичӧтмӧдӧм
литр	литр
литьё	
лиф	лип
лифт	лифт
лифчик	лип
лихачество	
лихачество	удаллун
лицей	лицей
лицо	бан
лицо	морт
лицовка	банӧдӧм
личина	лапӧд
лишек	
лишение	мырддьӧм
лов	шедӧм
ловля	куталӧм
ловля	кыйсьӧм
ловушка	нальк
лог	сён
логарифм	логарифм
логика	логика
логика	нырвизь
логопед	логопед
лодка	пыж
лодочник	пыжа
лодырь	дышпоз
ложбинка	сёртас
ложечка	морӧспань
ложка	пань
лозина	
лозунг	лозунг
локализация	йӧршитӧм
локализация	инасьӧм
локальность	йӧршитӧм
локальность	инасьӧм
локатор	локатор
локомобиль	локомобиль
локомотив	локомотив
локоть	гырддза
локус	сулаланін
ломанье	чегъялӧм
ломанье	жуглӧм
ломбард	ломбард
ломка	чегъялӧм
ломка	жуглӧм
ломка	косялӧм
ломка	вежӧм
лоно	морӧс
лопата	зыр
лопотанье	ватолитӧм
лось	йӧра
лосёнок	йӧрапи
лотерея	лотерея
лото	лото
лоток	саран
лохань	лӧкань
лошадка	
лошадник	
лошадь	вӧв
луб	сі
лубок	кард
луг	видз
луда	луж
лузга	кыш
лука	чукыль
лукавинка	наянтор
луковица	
луковица	йиткыр
луна	тӧлысь
лунка	юкмӧс
луч	югӧр
лучение	кыбӧм
львенок	левпи
льготность	кокньӧдлун
льстивость	лесьтлун
любезность	вежливлун
любовность	тӧждлун
любовь	радейтӧм
люк	мур
люстра	люстра
лютеранство	лютеранство
лютик	купальнича
люцерна	люцерна
лягушка	лягуша
лягушонок	лягушапи
ляда	
ляжка	лядьвей
ляпис	ляпис
ляпсус	лӧсявтӧмтор
лёгкость	кыпыдлун
лёд	йи
лёжка	видзӧм
лёжка	
лён	
лён	шабді
лётчик	лётчик
мавзолей	мавзолей
магарыч	
магарыч	калым
магистр	магистр
магний	магний
магнит	магнит
магнитола	магнитола
магнитофон	магнитофон
мазанье	сёялӧм
мазка	мавтӧм
мазут	мазут
мазь	мазь
мазь	мавтас
майка	майка
майонез	майонез
майор	майор
мак	мак
макет	макет
маклерство	сёрнитчӧдӧм
макрокосмос	енкола
максимум	медуна
максимум	
макулатура	шыблас
макуха	чаз
макушка	йыв
малиновка	ӧмидзкай
малица	малича
малодушие	полӧм
малость	ичӧтлун
малость	
малыш	
малышка	
малышня	посниулов
мальчишество	кокниасьӧм
мамаша	
мамка	
мамонт	мамонт
манго	манго
мандолина	мандолина
манеж	манеж
манна	
мануфактура	мануфактура
мануфактура	фабрика
мара	
маразм	шӧпъялӧм
марание	лякӧм
марафет	
марафон	
марганец	марганеч
маренго	рудовсьӧд
маринад	маринад
маринование	маринуйтӧм
марионетка	акань
марионетка	кесйылӧг
маркер	пас
маркетри	
маркирование	пасъялӧм
маркировщик	пасъялысь
марля	марля
мармелад	мармелад
мародёр	маклак
мародёрство	мародёралӧм
мародёрство	маклачитӧм
маршал	маршал
маршировка	маршируйтӧм
маска	маска
маска	сайӧд
маскирование	сайӧдӧм
масло	вый
масло	мавтас
маслобойка	
маслянистость	выялун
масса	масса
массировка	
массовка	
мастер	мастер
мастер	вӧчасьысь
мастерство	уджсям
мастика	мастика
маститость	мывкыдлун
масштабность	ыджда
математик	математик
математика	математика
материализм	материализм
материалист	материалист
матерщина	матькӧм
матерщинник	матькысь
матерь	энь
матица	матич
матка	энь
матка	мам
матка	компас
матрос	матрос
матушка	нылӧ
матч	матч
мафиози	мафияса
мах	ӧвтыштӧм
махина	удоробье
махинация	маклачитӧм
маховик	махӧвик
махорка	макорка
мачта	шолга
машина	машина
машинизация	машинизируйтӧм
машинист	машинист
машинистка	печатайтчысь
машинка	машинка
маятник	кыв
мгла	ру
мгла	рӧмыд
медаль	медаль
медальон	медальон
медведь	ош
медвежонок	ошпи
медиатор	медиатор
медицина	медицина
медленность	надзлун
медлительность	ньӧжмыдлун
медсестра	медсестра
медуза	медуза
медуница	тӧзь
медь	ыргӧн
межбровье	кыксинкост
междуречье	кыкюкост
междурядье	кыквизькост
междуцарствие	сартӧмдыр
межеумок	кидӧс
межёвка	юксьӧм
мезга	ли
мел	мел
меланхолия	жугыльлун
мелкота	поснитор
мелодика	шылад
мелодичность	мылалун
мелодрама	мелодрама
мелочность	артасьӧм
мелочь	
мельница	изанін
мелюзга	
мембрана	мембрана
менеджер	
мензурка	мензурка
менталитет	
ментол	ментол
мера	муртӧс
мера	туй
мерзость	
мерзость	зывӧклун
меридиан	меридиан
мерило	муртас
мерка	мурталӧм
мерка	муртӧг
мерность	торксьывтӧмлун
мертвечина	мерлина
мертвечина	дудандыр
мерёжа	ветель
месиво	
месиво	гудрас
местком	местком
местность	ин
местожительство	оланін
местоимение	нимвежтас
местоположение	сулаланін
местопребывание	оланін
месторождение	чужанін
месячник	тӧлысьдыр
металлопромышленность	металлопромышленносьт
металлург	металлург
металлургия	металлургия
метаморфоза	
метатеза	вешйӧм
метатель	чӧвтысь
метафизик	метафизик
метафизика	метафизика
метель	турӧб
метение	чышкӧм
метеорит	енэжиз
метизация	кидусалӧм
метина	пас
метис	кидус
метка	пас
метод	ног
метонимия	вуджним
метро	метро
метрополитен	метрополитен
механизатор	механизатор
механизация	механизируйтӧм
механизм	
механизм	механизм
механизм	машина
механик	механик
механика	механика
меч	шыпурт
мечтатель	мӧвпалысь
мешанина	гудрас
мешанка	
мешкотность	ньӧжмыдлун
мещанство	мещана
мзда	
мигание	синмасьӧм
мигание	ыпъялӧм
миграция	
мизгирь	черань
микроб	микроб
микрон	микрон
микроскоп	микроскоп
микроскопия	микроскопия
микрофильм	микрофильм
микрофон	микрофон
милиционер	милиционер
милиция	милиция
милиция	милиционеръяс
миллиметр	миллиметр
милостыня	милӧстина
милость	бурлун
милочка	
мимоза	мимоза
мимоза	тшаппоз
миндалина	миндалина
миндаль	
минерал	доніз
миниатюризация	ичӧтмӧдӧм
минимализм	медэтша
минимум	
минимум	
минимум	медічӧт
министр	министр
миномётчик	миномётчик
миноносец	миноносеч
минтай	минтай
минус	чинтыны
минус	тырмытӧмтор
минута	минут
минута	
мировоззрение	мӧвпсям
миска	тасьті
миссия	миссия
мистраль	войтӧв
митинг	митинг
митрополит	митрополит
митрополия	митрополитув
миф	миф
миф	мойд
мичман	мичман
мишка	ош
младость	томлун
мних	манак
многогранник	унабок
многогранность	унапӧлӧслун
многолюдье	суйим
многоугольник	унасэрӧг
многочлен	унашлен
множественность	уналун
множимое	босьтӧй
множитель	босьтысь
мобилизация	зэвтӧм
могила	
могильщик	гуалысь
могущественность	вынйӧр
мода	мода
модальность	модальносьт
модистка	
модистка	вурсьысь
модификация	
модник	тшапитчысь
модуль	модуль
можжевельник	тусяпу
мозаика	мозаика
мозаичность	ӧтгудырлун
мозг	вем
мозг	вежӧр
мокрица	нявда
молекула	молекула
моление	
моление	юрбитӧм
молитва	
молитва	юрбитӧм
молитва	буркыв
моллюск	лёльӧ
молниеотвод	чардкут
молодица	ичмонь
молодка	
молодка	
молодняк	
молодняк	томулов
молодчик	зон
молодь	
молозиво	чӧжйӧв
молоко	йӧв
молоко	сӧз
молокосос	зырымбедь
молот	мӧлӧт
молотильщик	вартысь
молоток	мӧлӧт
молочай	йӧлатурун
молчаливость	чӧвлун
мольба	
мольба	буркыв
момент	ком
монархия	монархия
монастырь	манастыр
монах	манак
монахиня	манакиня
монашество	манакалӧм
монашество	манакъяс
монета	сьӧмпас
монография	монография
монолитность	ӧтторъялун
монополизация	монополизируйтӧм
монополист	монополист
монтирование	тэчӧм
монтёр	
монтёр	электромонтёр
мор	
мор	пӧрӧс
море	саридз
морение	тшыгйӧдӧм
морж	морж
мороженое	лымвый
мороз	кӧдзыд
морозильник	кӧдзӧданін
морось	сибус
морошка	мырпом
морфей	ун
морфема	морфема
морфология	морфология
морщина	чукыр
моряк	моряк
мост	пос
мост	йитӧд
мост	посводз
мостик	сулаланін
моталка	таб
мотивировка	подулалӧм
мотовило	ректан
мотовоз	мотовоз
мотовство	шердйысьӧм
мотор	мотор
моторист	моторист
мотороллер	мотороллер
мотоцикл	мотоцикл
мотыга	кокан
мотыжение	кокӧм
мох	нитш
моча	кудз
мочеиспускание	кудзасьӧм
мощность	вын
мощность	кызта
мощность	вынйӧр
мощь	
мощь	ёнлун
мрамор	мрамор
мудрствование	мудритӧм
мужество	повтӧмлун
мужик	крестьянин
мужик	верӧс
муза	ловби
музей	музей
мультфильм	мультфильм
мундир	мундир
мундштук	мундштук
мундштук	вомкӧрт
муравей	кодзувкот
мурашка	
мурашка	
мурло	
мусульманин	мусульманин
мусульманство	мусульманство
мутация	
мутовка	кольтан
мутовка	кортуг
муха	гут
мученичество	мучитчӧм
мыло	майтӧг
мыс	кокад
мысик	йыв
мысль	вежӧр
мышеловка	нальк
мышонок	шырпи
мышь	шыр
мыщелка	калич
мягкосердечность	бурлун
мягкость	небыдлун
мясистость	чиглун
мясо	яй
мясо	сьӧмӧс
мясоед	
мясопуст	
мята	исаньтурун
мятежник	мятежник
мятьё	няръялӧм
мятьё	песӧм
мяуканье	нявзӧм
мяч	мач
мёд	ма
мёрзлость	кынлун
набег	уськӧдчӧм
набивание	тыртӧм
набивка	асыкалӧм
набор	набор
наборщик	набирайтчысь
набухание	польдӧм
навага	навага
наваристость	нӧгыльлун
наведение	веськӧдӧм
навеска	дзиръялӧм
навеска	дзир
наводнение	тыртӧм
наводчик	наводчик
навоз	куйӧд
навозник	мӧссітувгаг
навозница	
навозница	куйӧдасяндыр
навой	
наволочка	эжӧд
навязывание	кӧвъялӧм
нагайка	нагайка
награждение	наградитӧм
нагрев	донӧдӧм
нагревание	доналӧм
нагрузка	сӧвтӧм
надбавка	содтӧд
надзиратель	надзиратель
надлом	туйдчӧдӧм
надоеда	дӧзмӧдчысь
надпил	туйдчӧмин
надрыв	косьыштӧм
надсечка	сёртас
надстройка	надстрӧйка
надувка	пӧльтӧм
наездник	верзьӧма
наждак	наждак
нажиг	сотӧм
название	ним
назначение	мог
назревание	ордӧм
наименование	нимпас
накал	доналӧм
накат	йирк
накат	накат
накачка	качайтӧм
накачка	пӧльтӧм
накидка	павгӧд
накипь	шактар
наклад	
наклёпка	клепайтӧмтор
наковальня	накӧвальня
накомарник	номдӧра
наличник	карниз
наличность	
налог	вот
наложение	пуктӧм
намол	изӧм
намолот	вартӧм
нанесение	мавтыштӧм
нанесение	вӧчӧм
нанизывание	пысавлӧм
напилок	напилок
наплав	таб
наплавка	сывдӧм
наплечник	ластавич
наплыв	виялӧм
наплыв	йӧг
наполнение	тыртӧм
наполнение	тырӧм
направление	веськӧдӧм
напрасность	весьшӧрлун
напряжение	топалӧм
напряжённость	личлэдзлытӧмлун
напуск	лэдзӧм
напыление	бусӧдӧм
напёрсток	чуньлыс
нарастание	ӧддзӧм
наращение	быдтӧм
нарзан	нарзан
наркомания	наркомания
наркотик	дикмӧдчантор
народность	йӧзӧтув
нарубка	лӧсас
нарядность	мичлун
нарядчик	
насадка	сам
насадка	сад
насвистывание	шутьлялӧм
население	овмӧдӧм
насест	сёр
насечка	пинь
насечка	пинялӧм
насилие	нӧйтӧм
насилие	мырдӧналӧм
наскок	
наскок	уськӧдчӧм
наследование	рӧдйӧм
наследство	
наследство	
наследство	казьтыланпом
насморк	насмука
насос	насос
наст	чарӧм
наставка	тор
наставник	юрнуӧдысь
настой	
настриг	шырӧм
наступление	зырсьӧм
наступление	наступайтӧм
насыпка	лэптӧм
насыщение	пӧткӧдӧм
насыщение	тыртӧм
насыщение	пӧтӧм
натиск	зырсьӧм
натурализм	натурализм
наука	наука
наука	велӧдӧм
нафталин	нафталин
находка	корсьӧмтор
нахождение	корсьӧм
нацевка	сюри
национальность	нация
нация	канму
начало	зачин
начальство	
начатие	
начатие	джынъялӧм
начинка	тыралӧм
начисление	
начисление	содтӧд
начёс	зуалӧм
нашатырь	нашатыр
нашествие	
нашивка	вурӧс
небо	рай
невежда	им.
невеста	невеста
невеста	гӧтырпу
невестка	кев
невзгода	шог
невидаль	аддзывтӧмтор
невинность	правлун
невиновность	мыжтӧмлун
невод	тыв
невропатология	невропатология
нега	
нега	красуйтчӧм
негатив	негатив
негация	соссьӧм
неделя	вежон
недобор	чукӧрмытӧм
недоброе	лёктор
недоброжелательство	лӧгалӧм
недоверчивость	эскытӧмлун
недопёсок	кыньпи
недостача	судзсьытӧм
недосуг	
недосуг	эштытӧм
недоуздок	дом
недружелюбие	лӧгалӧм
неестественность	пычкӧм
нежелательность	ковтӧмлун
незыблемость	зумыдлун
неизвестное	тӧдтӧмтор
неисправность	торксьӧм
нейрон	нейрон
нейрохирург	нейрохирург
нейрохирургия	нейрохирургия
неловкость	укшальлун
нелюдимость	кидлун
ненасытность	пӧтлытӧмлун
необходимость	коланлун
неодушевлённость	ловтӧмлун
неожиданность	виччысьтӧм
неосторожность	видзчысьтӧмлун
неотступность	личлэдзлытӧмлун
неотёсанность	лӧсавтӧм
неохота	
неохота	
непереходность	вуджтӧмлун
непонимание	гӧгӧрвотӧм
непосредственность	веськыдлун
непостоянство	вежласьӧм
неправда	
неправда	
неприличие	лёктор
непринуждённость	вӧйсасьтӧмлун
неприятель	лӧгалысь
неприятность	кажитчытӧм
непроходимость	:
неразумие	вежӧрттӧмлун
нерв	
нерв	вей
нерест	
нерест	кульмӧм
неровность	коставлӧм
несбыточность	збыльмытӧмлун
несгибаемость	куснясьтӧмлун
несение	нуӧм
несчастье	
нетель	ялавич
неточность	ӧшыбка
неудобство	лӧсьыдтӧм
неудовлетворённость	майышлун
неуклюжесть	укшальлун
неурядица	
неучтивость	вежавидзтӧмлун
нехорошее	лӧсьыдтӧмтор
нечисть	
неяркость	пемыдлун
нива	удж
нивелир	нивелир
нивелирование	нивелируйтӧм
нигилизм	
нигилизм	увтыртӧм
нигилист	нигилист
низание	пысавлӧм
низка	сыр
никчёмность	ковтӧмлун
нитка	сыр
нитроглицерин	нитроглицерин
нитченка	вӧрт
нить	
ниша	горс
нищета	гӧлюлов
новация	выльтор
новина	
новинка	выльтор
нога	кок
ноготь	гыж
ноздря	син
нокаут	нокаут
номер	номер
номерок	номерок
норд	
норд	войвыв
нос	ныр
носоглотка	ныркӧрша
носорог	
ночва	шердын
ночник	дзузган
ночь	вой
нудист	нудист
нумерация	номеруйтӧм
нумерация	дорвывтӧм
нутрия	
нутро	сьӧлӧм
нянечка	
нянька	
оазис	оазис
оба	ис.
оба	ӧтмӧдар
оба	кыкнан
обабок	кӧчгоб
обделка	вӧчӧм
обеднение	гӧльмӧм
обеднение	гӧльмӧдӧм
обедня	ӧбедня
обезьяна	ӧблезяна
обелиск	обелиск
оберег	видзӧг
обескровление	вынтӧммӧм
обеспеченность	могмӧдӧм
обеспложивание	изгармӧдӧм
обеспложивание	гӧльмӧдӧм
обесцвечение	кельдӧдӧм
обесцвечение	бледмӧм
обжаривание	жаритыштӧм
обжорливость	пӧтлытӧмлун
обзор	тыдалӧм
обивка	нӧйтӧм
обивка	эжӧд
обида	
обида	ӧбиднӧ
обитатель	олысь
обитель	манастыр
обколка	чуктӧдтӧм
область	обласьт
облатка	кышйӧг
облачение	пасьтӧдӧм
облачение	пасьтасьӧм
обледенение	йизьӧм
облепиха	облепиха
облечение	пасьтӧдӧм
обливание	киськасьӧм
обливание	киськалӧм
облигация	облигация
облом	чегӧм
облом	чегӧмин
облучение	
обмазка	мавтӧм
обмазка	мавтас
обмер	мерайтӧм
обмин	
обмин	талялӧм
обмин	небзьӧдӧм
обмолот	вартӧм
обмотка	
обмывание	мыськалӧм
обмётывание	быгӧртӧм
обнесение	гӧгӧртӧдӧм
обобщение	ӧтвывтӧм
обогатитель	
обогащение	бурмӧдӧм
обогревание	шонтӧм
обогреватель	шонтӧд
обод	ворч
обод	кытш
обоз	обоз
обозначение	пасйӧм
обойма	обойма
оболочка	веркӧс
оболочка	кучик
обоняние	нырис
оборачиваемость	бергӧдчӧм
оборот	кывйит
оборотливость	писькӧслун
обоснование	подулалӧм
обоснование	подув
обособление	торйӧдӧм
образец	пример
образец	ног
обрамление	рамкаалӧм
обрамление	доргӧгӧр
обращение	бергӧдӧм
обращение	вуджӧм
обращение	вӧдитчӧм
обращение	шыӧдчӧм
обращение	
обрезка	вӧчӧм
обременение	сьӧктӧдӧм
обременительность	сьӧкыдлун
обретение	аддзӧм
обрешётка	решетина
обруб	
обрубка	быгӧртӧм
обрубщик	увйысьысь
обруч	асык
обруч	кытш
обрыв	орӧдӧм
обрыв	орӧм
обсерватория	обсерватория
обследование	прӧверитчӧм
обслуга	
обслуга	могмӧдӧм
обслуга	кесйылӧсъяс
обслуживание	уджӧдӧм
обслуживание	могмӧдӧм
обструкционист	обструкционист
обсыпка	гизьвидзӧм
обтирание	зырасян
обтирка	
обтирка	чышкӧд
обточка	шыльӧдӧм
обувание	кӧмасьӧм
обувание	кӧмӧдӧм
обух	тыш
обучение	велӧдӧм
обучение	велӧдчӧм
общежитие	ӧтуволанін
общественник	общественник
общество	котыр
община	котыр
объедение	
объедение	чӧскыдтор
объект	объект
объектив	объектив
объективизм	
объективизм	объективизм
объективизм	веськыдлун
объективность	веськыдлун
объяснение	помка
объёмность	ыдждалун
овечка	баляпи
овеществление	
овин	рыныш
овёс	зӧр
огарок	сисьпом
оглядка	видзчысьӧм
огнёвка	
огонь	би
огонь	лыйсьӧм
огонёк	битор
огораживание	потшӧм
ограничение	чинӧм
огрубение	чорзьӧм
огурец	ӧгуреч
одеколон	одеколон
одиночество	ӧткалун
однолеток	
односложность	дженьыдлун
одобрение	ошкӧм
одобрение	вынсьӧдӧм
одоление	вермӧм
одушевление	
одушевлённость	ловъялун
ожерелье	сикӧтш
ожесточение	чорыдлун
ожидание	виччысьӧм
ожог	сотчӧм
ожог	сотчӧмин
озарение	
озвучивание	шыӧдӧм
озеро	ты
ознакомление	тӧдмӧдӧм
ознобление	кынтыштӧм
окантовка	доралӧм
оканье	окайтӧм
окись	окись
окно	ӧшинь
око	син
околица	
околица	сиктсай
околичность	кытшлӧдлӧм
окончание	пом
окончание	кывйыв
окоп	окоп
окорм	
окорм	пагӧдӧм
окостенелость	бертласьтӧмлун
окраска	мичӧдӧм
окраска	рӧм
окрик	
округление	гӧгрӧстӧм
округление	гӧгрӧсмӧм
окружность	выйт
окружность	гӧгӧртас
окрыление	
окрыление	бордъясьӧм
октава	октава
окунь	ёкыш
окурок	чигаркапом
окучник	кокан
оледенение	йизьӧм
олень	кӧр
олигарх	олигарх
олимпиада	олимпиада
олицетворение	морткодялӧм
олово	озысь
ольха	ловпу
омертвление	виӧм
омоложение	томмӧдчӧм
омуль	омуль
омут	вабергач
онанизм	онанизм
ондатра	ондатра
онуча	нямӧд
опаздывание	сёрмӧм
опала	
опала	мустӧмтӧм
опасение	полӧм
опека	тӧралӧм
опекунство	тӧралӧм
опера	опера
оперетта	оперетта
опечатывание	печатайтӧм
опий	опий
описание	опишитӧм
описка	торксьӧм
опись	гижӧм
опись	лыддьӧг
опиум	
оплеуха	
оплодотворение	гӧрддзысьӧм
оплот	мыдж
оплывание	буждӧм
оповещение	юӧр
опоздание	сёрмӧм
ополчение	ополченньӧ
оппортунизм	оппортунизм
оппортунист	оппортунист
определение	тӧдмалӧм
определение	индӧм
определение	урчитӧм
определитель	индӧд
опрелость	нёльзьӧм
опрелость	нёльзьӧмин
оприходование	приходуйтӧм
опровержение	вочасьӧм
опт	
оптика	оптика
опускание	кольӧм
опустошение	
опухлость	пыктӧм
опущение	кольӧм
опущение	лэччӧм
опыливание	пызьналӧм
опыт	опыт
орало	гор
орбита	орбита
оргазм	оргазм
организатор	котыртысь
организация	котыртчӧм
орда	орда
ордер	ордер
орел	кутш
ориентировочность	ылӧсаланлун
оркестр	оркестр
орлёнок	кутшпи
орошение	кӧтӧдӧм
орфография	гижанног
осадка	пуксьӧм
осведомлённость	тӧдӧм
освещение	би
освободитель	мездысь
освящение	вежӧдӧм
осеменение	тырсьӧдӧм
осень	ар
осетрина	ӧсетрина
осечка	тяльскӧм
осина	пипу
оскопление	кодзӧм
ослабление	
ослепление	синтӧммӧдӧм
ослепление	ёрӧм
ослизлость	нильӧглун
ослёнок	осёлпи
осмолка	сиралӧм
осмотрительность	видзчысьӧм
основа	подув
основа	кывдін
основание	латш
осока	эжӧр
осот	йӧн
остановка	сувтӧдӧм
остаток	коляс
остаток	коляс
остойчивость	дзибрасьтӧмлун
осторожность	видзчысьӧм
остракизм	
остриё	ёсьлун
остров	ді
острога	азьлас
осушение	косьтӧм
ось	чӧрс
осьминог	осьминог
осёл	осёл
осётр	осётр
отава	ӧтава
отапливание	ломтӧм
отбеливатель	белитчантор
отбой	дугӧдӧм
отбор	бӧрйӧм
отверделость	чорзьӧм
отверделость	чорзьӧмин
отверстие	розь
отверстие	син
отвес	отвес
отвесность	крутлун
ответ	кывкутӧм
ответ	ӧтвет
ответвление	вожӧдӧм
ответвление	вожалӧм
ответственность	кывкутӧм
ответчик	кывкутысь
отвратительность	зывӧклун
отвращение	ӧлӧдӧм
отвёртка	ӧтвертка
отгибание	веськӧдӧм
отгибка	
отгон	ылі
отдаление	ылі
отдание	сетӧм
отдача	сетӧм
отделение	юкӧн
отдушник	душник
отзыв	чӧвтӧм
откол	
откол	торйӧдӧм
откорм	тшӧгӧдӧм
откормыш	тшӧгӧдантор
откос	пӧкат
открепление	мынӧм
откровение	
откровенность	восьсалун
открывалка	восьтан
открытие	восьтӧм
открытие	тыдӧдӧм
открытость	восьсалун
откупоривание	восьтӧм
откупоривание	воссьӧм
откусывание	курччалӧм
отливка	кисьтӧмтор
отлогость	тшӧтшамӧсін
отложение	пуксьӧм
отложение	пуктӧг
отломок	чегӧмтор
отлучка	ветлӧм
отмачивание	
отмерзание	кынмӧм
отмеривание	мурталӧм
отметка	пасйӧм
отметка	туйпас
отмирание	бырӧм
отмирание	кулӧм
отмочка	кӧтӧдӧм
отмывание	
отнятие	вундӧм
отображение	серпас
отогревание	
отогревание	шоналӧм
оторочка	дорӧсалӧм
отпевание	сьылӧдӧм
отпечаток	туй
отпирательство	соссьӧм
отпрыск	йылӧм
отпрыск	кага
отработка	шыльӧдӧм
отражение	тыдалӧм
отрасль	юкӧн
отращивание	быдтӧм
отребье	
отрез	вундас
отрез	тшытш
отречение	кӧдзӧдчӧм
отрицание	соссьӧм
отрицание	отрицанньӧ
отруб	вундас
отрыв	вештӧм
отряд	отряд
отсебятина	
отсев	пожналӧм
отсев	чинӧм
отслойка	
отстой	сук
отстрочка	стрӧчитӧм
отступление	кежӧм
отток	визувтанін
отторжение	вӧтлӧм
оттяжка	нюжӧдчӧм
отход	бӧрыньтчӧм
отцепление	мынӧм
отцепление	мынтӧдӧм
отчаянность	сьӧкыдлун
отчётливость	ясыдлун
отшельник	
отщеп	чальдӧг
отщепление	торйӧдӧм
отщепление	торъялӧм
отъезд	мунӧм
отыгрыш	ворссьылӧмтор
отягощение	сьӧктӧдӧм
отягчение	сьӧктӧдӧм
официантка	официантка
офсет	офсет
охват	шымыртӧм
охват	сывтыр
охвостье	
охлаждение	ыркӧдчӧм
охотовед	охотовед
оценка	дон
оцеп	лайкан
оцепление	кытш
очерк	очерк
очертание	серпас
очистка	сӧдзӧдӧм
очистка	весалӧм
очиток	дзуртантурун
очищение	
очко	очко
павильон	павильон
павлин	павлин
падалица	
падение	
падение	усьӧм
падь	
пазуха	питшӧг
пазуха	
пазуха	
пакет	пакет
пакт	пакт
палата	палата
палеограф	палеограф
палеонтолог	палеонтолог
палец	чунь
палка	бедь
палка	палич
палка	тас
палочка	дзоль
палочка	быгльӧс
палтус	палтус
палуба	палуба
пальма	пальма
пальто	пальто
пампушка	аладдя
памятка	казьтӧд
памятник	казьтӧд
панама	панама
панариций	ызӧнувтыс
панель	моски
панихида	панапида
панно	
пансионат	пансионат
пантера	пантера
панцирь	панцыр
папаха	папаха
папироса	папирос
папка	папка
папоротник	лудіктурун
пара	гоз
пара	кыкӧн
пара	кык
параграф	юръюкӧд
парад	парад
парадигма	бала
парадность	кыпыдлун
паразит	паразит
паралич	паралич
параллель	параллель
парапет	перилӧ
парашют	парашют
парашютистка	парашютистка
пари	заклад
парик	парик
парикмахер	шырысь
парикмахерская	шырсянін
парламент	парламент
парламентёр	парламентёр
парник	парник
паровоз	паровоз
пародия	пародия
пароход	паракод
пароходство	паракодство
парта	парта
партер	партер
партизан	партизан
партизанка	партизанка
парус	тӧвдӧра
парфюмерия	парфюмерия
парча	парча
парша	лӧм
пасека	делянка
пасмо	пасма
пасовка	пасуйтӧм
паспорт	паспорт
пассия	мусук
паста	паста
паста	гудрас
паства	вичкоувса
пастила	пастила
пастырь	пастук
пастырь	поп
патент	патент
патефон	патефон
патронташ	патронташ
патруль	патруль
паук	черань
пафос	кыпыдлун
пах	йӧрвуждін
пахарь	гӧрысь
пахтанье	
пачка	пачка
пащенок	зырымбедь
паёк	юкас
певец	сьылысь
певучесть	мылалун
педагогика	педагогика
пек	вар
пекло	би
пемза	пемза
пенициллин	пенициллин
пеночка	пеночка
пенсионер	пенсионер
пенсионерка	пенсионерка
пенсия	пенсия
пень	мыр
перванш	рудовлӧз
первогодок	
первозимье	
первооткрыватель	восьтысь
перебазирование	вуджӧдӧм
перебивание	
перебирание	
перебирание	видлалӧм
перебор	разьлӧм
перебор	вежласьӧм
переборщик	бӧрйысьысь
переброска	нюжӧдӧм
перевес	верктуй
перевес	лайкан
перевеска	
перевод	вуджӧдӧм
перевод	вештӧм
перевод	вуджӧдӧмтор
перевод	тӧдчӧдӧм
перевозчик	вуджӧдчысь
переворачивание	бергӧдлӧм
перевыполнение	вевтыртӧм
перегон	вӧлӧк
перегонка	вийӧдӧм
перегораживание	вежӧсалӧм
перегорание	сотчӧм
передача	сетӧм
передача	вуджӧм
передача	петкӧдлӧм
передача	удтӧм
передвижение	вуджӧдӧм
передвижка	
передвижка	
передовая	
передёргивание	кезйӧдлӧм
переезд	вуджӧм
переезд	туйкост
перекал	
перекал	доналӧм
перекись	перекись
переключатель	переключатель
перекос	вешкыртчӧм
перекручивание	путшкӧм
перекручивание	бертовтӧм
перекрытие	вевтыртӧм
переливание	
переливчатость	пӧртмасянлун
переливчатость	гылыдлун
перелицовка	бергӧдӧм
перелом	чегӧмин
перемена	вежӧм
переменчивость	вежласьӧм
перемирие	бурасьӧм
перемол	
перемол	изӧм
перемычка	венӧр
перенесение	вуджӧдӧм
перепалка	
перепалка	
перепашка	
перепев	дольӧм
переписка	печатайтӧм
переписчик	печатайтчысь
переплетение	кыӧм
переплетение	кыанног
переплёт	коркаалӧм
переплёт	корка
перепёлка	
переработка	
перерастание	вуджӧм
перерезывание	потшӧм
перерисовка	тӧдчӧдӧм
перескок	чеччыштӧм
перестарок	
перестройка	вежӧм
перетаскивание	кыскӧм
перетягивание	кыскасьӧм
переход	вуджӧм
переход	вешйӧг
перечерчивание	чертиталӧм
перечисление	лыддьӧдлӧм
перешеек	венӧр
перл	вӧсьӧ
перламутр	перламутр
перпендикуляр	перпендикуляр
перрон	перрон
персик	персик
персона	морт
перхоть	
перхоть	киль
песенник	сьылысь
пескоройка	нюглей
песнопевец	
песнь	
песнь	
песок	лыа
пест	тоин
пестунья	
пестунья	
петлица	петлича
петля	пекля
петля	пекля
петля	дзир
петля	лэч
петля	гарчикыль
пехота	пехота
печатание	печатайтчӧм
печать	печатайтанног
печать	печат
печень	мус
печенье	пӧжалӧмтор
печенье	печенньӧ
печурка	горс
печёнка	
пешка	пешка
пешня	пыридз
пианино	пианино
пиво	сур
пигалица	вадоркай
пиджак	пинжак
пижама	пижама
пижма	деветибрат
пикирование	пикируйтӧм
пикульник	чипсан
пикша	пикша
пила	пила
пилигрим	
пилка	
пилотаж	лэбаланног
пилотка	пилотка
пильщик	пилитчысь
пингвин	пингвин
пинцет	тотшыс
пион	маръямоль
пионер	пионер
пипетка	пипетка
пирамида	пирамида
пирамидка	турыш
пирог	пирӧг
пирожное	пирожнӧй
пирожок	пирӧжки
писака	иж.
писание	гижӧмтор
писатель	гижысь
писец	
писец	
пискун	
пистон	пистон
письмецо	письмӧтор
питание	вердӧм
питательность	пӧтӧслун
пицца	пицца
пичуга	кайпи
пищаль	пушка
пищик	чипсан
плавание	плавъялӧм
плавание	дзӧвкъялӧм
плавень	сывдӧг
плавка	сывдӧм
плавление	сылӧм
плакат	плакат
планеризм	планеризм
планерист	планерист
планета	планета
планетарий	планетарий
планка	планка
планка	дзав
планка	кард
планёр	планер
пласт	палак
пластика	пластика
пластина	плашки
пластинка	пластинка
пластичность	лайкыдлун
пластмасса	пластмасса
пластырь	пластыр
плата	дон
плата	водзӧс
платок	чышъян
платформа	платформа
плаун	кӧчвӧнь
плаха	плака
плач	
плашка	пырчеччан
плащ	плаш
племя	котыр
плен	плен
пленум	пленум
плетение	кыӧм
плетение	сьӧкталӧм
плетёнка	
плечико	волыс
плечо	пельпом
плечо	зор
плешь	
плита	плита
пловец	варччысь
плодообразование	гӧрддзысьӧм
пломба	пломба
плоскость	тшӧтшкӧс
плоскость	борд
плоскость	бок
плот	пур
плотность	топыдлун
плотовщик	клячасьысь
площадка	ӧтъяин
площадь	ыджда
площадь	изэрд
плуг	гӧр
плугарь	гӧрысь
плюрализм	унапӧлӧслун
плюс	шоныд
пляска	йӧктӧм
плясовая	йӧктӧдантор
плясун	йӧктысь
плёнка	кень
плёнка	плёнка
плёс	вомын
побасенка	
победитель	вермысь
побуждение	
повал	пӧрӧдӧм
поверка	прӧверитӧм
поверка	
поверье	поверье
поветрие	
поветрие	пӧрӧс
поветь	сайник
повешение	ӧшӧдӧм
повидло	повидло
поводырь	новлӧдлысь
поворот	кытшов
повседневность	быдлунъятор
повышение	джудждӧдӧм
повышение	джудждаммӧм
повязка	кӧртӧд
поганка	понтшак
погань	
погасание	кусӧм
поглощение	ньылыштӧм
поговорка	кывйӧз
погода	поводдя
погреб	кӧбрӧг
погремушка	торган
погудка	
погудка	
подача	сетӧм
подача	петкӧдлӧм
подаяние	милӧстина
подбавка	
подболтка	
подболтка	нур
подболтка	ныас
подборка	
подбородок	тшӧка
подвеска	
подвиг	подвиг
подвижность	бертласьӧм
подвластность	асвӧлятӧмлун
подводка	
подворотничок	юрйылув
подвязка	кӧрталӧм
подгибка	кусыньтӧм
подгон	
подготовка	тӧдӧмлунъяс
подданный	подданнӧй
подданство	подданство
поддерживание	
поджарость	косньӧдлун
поджатие	топалӧм
подзащитный	доръянтор
подкова	подков
подкоп	кодйысьӧм
подлежащее	подувпас
подлинность	збыльлун
подмазка	мавтыштӧм
подмерзание	кӧдзавлӧм
подмеска	ныас
подмеска	
подмывание	мыськыштӧм
подмывание	кырӧдӧм
подмышка	киняув
подножие	подув
подноска	ваялӧм
подношение	
подношение	калым
поднятие	джудждӧдӧм
поднятие	кыпӧдчӧм
поднятие	лыбӧм
подобность	ӧткодьлун
подогреватель	шонӧдчантор
подозрение	чайтӧм
подол	водз
подопревание	тӧрмӧм
подопревание	нёльзьӧм
подорлик	кутш
подорожник	
подосиновик	гоб
подотдел	юкӧдув
подпалина	пеган
подпечек	пачув
подпил	
подпилок	напилок
подписка	гижсьӧм
подписка	гижсьӧдӧм
подписывание	
подполковник	подполковник
подполье	гӧбӧч
подпруга	пӧдпруга
подражание	нерӧм
подраздел	юкӧдув
подразделение	юкӧн
подрастание	быдмыштӧм
подрезывание	
подробность	поснитор
подрядчик	медалысь
подсадка	
подсаживание	
подсвист	шутьлялӧм
подсинивание	лӧзӧдӧм
подсказчик	
подскакивание	
подскок	чеччыштӧм
подслушивание	кывзысьӧм
подсмеивание	серавлӧм
подснежник	лымдорчача
подсолнечник	шондіюр
подсолнух	
подсолнух	
подспорье	отсӧг
подстановка	
подстил	
подстил	вольсалӧм
подстилка	
подстилка	вольӧс
подстрижка	шырсьӧм
подтаивание	ульдӧм
подталкивание	тойлӧм
подтверждение	збыльмӧм
подтверждение	эскӧдантор
подтирание	ветьӧкалӧм
подтирание	вуштӧм
подтирка	
подтирка	
подтопка	
подтопка	ломзьӧдчан
подтяжка	зэлӧдӧм
подтёк	
подчистка	весалыштӧй
подчистка	вуштӧм
подшивка	быгӧртӧм
подшипник	подшипник
подъезд	пыранін
подъём	катӧм
подыскание	кӧрсьӧм
подёргивание	сырмӧм
поезд	поезд
поездка	ветлӧм
пожива	кӧрӧстуйтчантор
пожня	видз
пожня	идза
позволительность	позянлун
поздравление	чолӧмалӧм
позём	куйӧд
поилец	
поилка	
поилка	
поисковик	корсьысьысь
показ	индӧм
покачивание	довкмунӧм
покаяние	висьтасьӧм
поклонение	
поклонение	юрбитӧм
покой	спокой
покос	ытшкӧм
покраснение	гӧрдӧдӧм
покров	
покров	
покровитель	дорйысь
покрытие	мавтӧм
покрытие	виӧм
покрышка	вевттьӧд
покус	чушкӧм
пола	пӧла
полдень	лунвыв
поле	йиджтас
поленница	чипас
ползун	кыскасьысь
полив	киськалӧм
полив	киськасьӧм
полигон	полигон
полиграфия	полиграфия
поликлиника	поликлиника
полировка	лӧст
полиция	полиция
полиэтилен	полиэтилен
полк	полк
полковник	полковник
полководец	полководеч
полномочие	полномочие
полночь	войвыв
половина	джын
половник	дар
полог	вон
полог	шебрас
положение	оланног
положение	гӧгӧрвоӧдӧм
поломка	чегъясьӧм
поломка	торксьӧм
полоса	визь
полоса	от
полоса	ру
полоскание	пожъясьӧм
полотнище	лента
полотно	дӧра
полоумие	вошласьӧм
полуда	лудитӧм
полуда	луж
полумгла	рӧмыд
полуостров	кӧдж
полупроводник	полупроводник
пользование	вӧдитчӧм
пользователь	вӧдитчысь
полюс	полюс
помазок	мавтчан
поместительность	тӧранлун
помета	
помещение	водтӧдӧм
помещик	помещик
помещица	помещича
помидор	помидор
помин	казьтылӧм
помол	
помольщик	изӧдчысь
поморье	Войсаридздор
помост	брундук
помост	звӧз
помощник	вежысь
помутнение	гудыртчӧм
понедельник	выльлун
пономарь	пӧнӧмар
поноска	
пончик	пончик
понятой	понятӧй
попадья	попаддя
поперечина	тас
попечительство	тӧждысьӧм
поплин	поплин
поправка	лӧсьӧдӧм
поправка	бурмӧм
поприще	удж
попрошайка	иж.
попугай	попугай
попытка	видлӧм
порнография	порнография
порог	тагӧс
порода	доніз
поролон	паралон
порох	порок
порочность	мывкыдтӧмлун
портмоне	портманет
портупея	портупея
портфель	портфель
портянка	нямӧд
порубка	керас
порубщик	пӧрӧдчысь
поршень	поршень
посвист	шутляланног
посев	кӧдзӧм
поселение	овмӧдӧм
поселение	овмӧдчӧм
посеянное	кӧдзӧмтор
посинение	лӧзӧдӧм
поскок	чеччыштӧм
посконь	увпыш
последовательность	дорвывлун
послелог	кывбӧр
послесловие	бӧркыв
пословица	шусьӧг
послушность	кывзысьӧм
посольство	посольство
поспевание	кисьмӧм
поспешность	тэрмасьӧм
посредство	
поставка	поставка
постановка	пуктӧм
постановка	кутӧм
постановка	спектакль
постановление	шуӧм
постель	вольпась
постель	узьлӧм
постирушка	керасьыштӧм
постоянность	вежласьтӧм
пострел	вильышпоз
постриг	тырсьӧм
постромка	тяга
поступление	пырӧм
поступление	воӧм
постфактум	лоӧмтор
посудина	
посёлок	посёлок
пот	ньылӧдӧм
потасовка	
потемнение	пемдӧм
потешность	тешкодьлун
поток	визлас
поток	люзьгӧм
потомство	
потребление	видзӧм
потускнелость	пемдӧм
потягивание	кыскалӧм
похабность	понъясьӧм
похвальность	ошкӧм
похититель	гусялысь
похищение	гусялӧм
похмелье	пӧкмелитчӧм
похмелье	пӧкмелля
похожесть	ӧткодьлун
початок	каттьӧм
почва	подув
почерк	киподтуй
починок	
починок	тыла
починок	пӧчинок
почка	гар;
почки	вӧрк
почта	пошта
почтительность	вежавидзӧм
пошлина	мын
пощипывание	нетшкыштӧм
появление	петӧм
пояс	кос
пояс	пояс
поясница	кос
правда	веськыдлун
правда	4
правда	
правда	збыль
правда	
правдивость	веськыдлун
правильность	веськыдлун
правитель	юралысь
правитель	веськӧдлысь
правомочие	правомочие
правописание	гижанног
православие	православие
правосудие	
правосудие	правосуддьӧ
прагматизм	прагматизм
практика	практика
практика	опыт
практикант	практикант
пранарод	подувйӧз
прапорщик	прапорщик
прах	шой
прачечная	песласянін
прачка	песласьысь
праязык	подувкыв
предварение	
предварение	пановтӧм
предварительность	ылӧсалӧм
предвестник	туналысь
предвестник	вайысь
предгорье	гӧраберд
предикат	предикат
предисловие	водзкыв
предок	пӧль
предоставление	сетӧм
предостережение	ӧлӧдантор
предосторожность	видзчысьӧм
предосудительность	дивитантор
предотвращение	видзчысьӧм
предохранение	видзӧм
предохранение	видзчысьӧм
предохранитель	предохранитель
предписание	тшӧктӧд
предписание	урчитӧм
предположительность	чайтӧм
председатель	нуӧдысь
предсердие	сьӧлӧмводз
представление	тӧдмӧдӧм
представление	висьталӧм
предуведомление	юӧртӧм
предупреждение	видзчысьӧм
преемственность	вуджӧм
президент	президент
преимущество	
преисподняя	
преисподняя	ад
прелюдия	панас
премирование	премируйтӧм
премия	премия
премьер	
прение	нёльзьӧм
преображение	вежӧм
преображение	вежсьӧм
препарат	препарат
препарирование	вундалӧм
преподношение	козин
препровождение	коллялӧм
пресность	дубыдлун
пресс	жӧм
престарелость	пӧрысьлун
претензия	корӧм
преуменьшение	чинтӧм
префикс	кывводз
прибавление	содтӧм
прибавление	содӧм
прибаутка	кывйӧз
прибежище	
приближённость	ылӧсалӧм
прибыль	содӧм
приварка	
приварка	пузьӧдӧмин
приварка	пузьӧдӧмтор
приведение	вайӧдӧм
привесок	
прививка	кокась
прививка	выльдӧм
привинчивание	винтитӧм
привлечение	кыскӧм
привыкание	велалӧм
привыкание	сьӧдъяммӧм
привязанность	радейтантор
привязчивость	сибыдлун
пригон	вайӧдӧм
пригоршня	содз
пригрев	гожводз
приданое	приданнӧй
придаток	содтӧд
придуманное	думыштӧмтор
приживал	
прижигание	сотӧм
приз	приз
призвание	мог
приземление	пуксьӧм
призма	призма
призрак	
призрак	орт
призывник	салдатпу
приказчик	
приказчик	вузасьысь
прикидка	ылӧсалӧм
прикладывание	матыстӧм
прикладывание	ляскысьӧм
приклёпка	клепайтӧм
прикосновение	
прикус	пиньмурч
прилагательное	кывберд
прилив	шыбитчӧм
прилизанность	шыльыдлун
прилипала	иж.
приложение	содтӧд
прима	
приманка	ылӧдӧм
пример	мыччӧд
пример	пример
примитив	
примус	примус
примыкание	сибӧдӧм
принадлежность	кӧлуй
принесение	сетӧм
принц	принц
принцесса	принцесса
принятие	чайтӧм
приобретение	босьтӧм
приобретение	шедӧдӧмтор
припев	сьывтас
приподнятость	кыпыдлун
припуск	лэдзӧм
припуск	запас
приравнивание	ӧткодялӧм
приращение	содӧм
приречье	вадор
прирост	содӧм
присовокупление	содтӧм
приспособление	лапкан
пристав	пристав
приставка	кывводз
приступ	босьтчӧм
приступок	тшупӧд
присыхание	косьмӧм
присядка	йӧктанног
притирание	велалӧм
приток	содӧм
приток	вож
притча	дивӧ
притяжательность	асалӧм
притяжение	кыскӧм
притязание	
приуменьшение	чинтыштӧм
приучение	велӧдӧм
прихлебатель	
прихлебательство	кытшкылясьӧм
прихоть	номсасьӧм
прицел	мет
прицепка	крукалӧмтор
причал	ӧзын
причет	лыддьӧдлӧм
причисление	содтӧм
пришивка	вурӧм
приязнь	
приязнь	ёртасьӧм
приём	босьталӧм
проба	видлӧг
проба	проба
пробег	котӧртӧм
пробирка	пробирка
пробка	помӧд
прободение	письтӧм
пробой	
проборка	чирыштӧм
проборка	весалӧм
провал	кисьтӧм
провал	вештӧм
провал	провалитӧм
провал	провалитчӧм
проведение	нуӧдӧм
провеивание	тӧлӧдӧм
проветривание	ыркӧдчӧм
провинность	мыж
провинциал	
проводка	
проводка	
провозглашение	нимӧдӧм
проволока	сутуга
прогалина	
программа	уджтас
программист	уджтасалысь
прогрев	шоналӧм
прогрессия	прогрессия
продление	нюжӧдӧм
продолговатость	кузьмӧслун
продуктивность	продуктивносьт
проект	бала
проекция	
проживание	олӧм
прожилка	сӧн
проигрывание	ворссьӧм
проигрывание	ворсӧм
проигрыш	ворссьӧм
произведение	вӧчӧмтор
произведение	произведенньӧ
производственник	уджалысь
произношение	шуанног
происшествие	лоӧмтор
проказливость	вильышлун
прокладка	сюйӧд
проклейка	клеитчӧм
прокорм	
прокорм	вердӧм
прокос	покос
прокуратура	прокуратура
прокурор	прокурор
пролетариат	пролетариат
промерзание	кынмӧм
промокание	кӧтасьӧм
пронизь	пысӧд
проникновение	
пронос	пыртӧм
пронырливость	писькӧслун
прообраз	
прообраз	
пропажа	вошӧмтор
пропарка	пожӧм
пропил	вундас
пропилка	пилитыштӧм
прописка	гижӧдӧм
прописка	овмӧдчӧм
пропись	гижансер
пропитание	
пропитание	вердӧм
пропитка	тыасьӧм
пропитка	йиджтантор
проповедник	бурсьылысь
пропуск	лэдзанпас
пропуск	
прорва	
просвещённость	велӧдчӧмлун
просеивание	пожнассьӧм
просекание	керыштӧм
прослойка	пӧвст
прослушивание	кывзӧм
просо	проса
просодия	просодия
просол	солалӧм
простаивание	сулалӧм
проституирование	
проститутка	вузань
проституция	кырсасьӧм
простыня	прӧстыня
просянка	зӧрна
проталкивание	ӧддзӧдӧм
протаскивание	кыскӧм
протаскивание	сюйӧм
противень	лист
противогаз	противогаз
противопоставление	орччӧдӧм
проток	сӧн
протокол	пасйӧд
протон	протон
протрава	
протрезвление	палялӧм
протрезвление	пальӧдӧм
протухание	дуксьӧм
протягивание	кыскӧм
проулок	уличкост
профан	мӧмӧт
профессор	профессор
профессура	профессоръяс
проход	розь
процент	прӧчент
процесс	процесс
прочтение	гӧгӧрвоӧдӧм
прочёс	зуалӧм
прошение	корӧм
прощение	прӧститӧм
прощение	прӧща
проявка	тыдӧдӧм
проявление	
пруд	пруд
прыганье	чеччалӧм
прыгун	чеччалысь
прыжок	чеччыштӧм
прыткость	
прядение	печкӧм
прядильщик	печкысь
прядь	прать
пряжа	печкӧм
прямизна	веськыдлун
прямодушие	веськыдлун
прямолинейность	веськыдлун
прямоугольник	веськыдсэрӧг
пряник	преник
прясло	
прясло	потшӧс
прясло	вешала
псина	
птаха	кай
пташка	кайпи
птичка	пас
публикация	чуйдӧс
публицист	публицист
публицистика	публицистика
пугало	чучела
пуд	пуд
пудра	пудра
пузырь	гадь
пузырь	
пузырь	дуль
пузырёк	сулеятор
пульверизация	бусӧдӧм
пульт	пульт
пуля	пуля
пункт	мӧвп
пункт	юкӧн
пунктир	визьчут
пуночка	кӧнсыкай
пупок	гӧг
пупырь	
пупырь	
пуск	лэдзӧм
пустыня	пустыня
пустышка	
пустяк	
путь	туй
путёвка	путёвка
пух	ловгӧн
пушение	пушитӧм
пушица	гӧнаюр
пушка	пушка
пушок	ловгӧн
пуштунка	афганка
пуштуны	афганечьяс
пчельник	
пшеница	шобді
пшено	проса
пыль	бус
пытка	мучитчӧм
пышка	кӧвдум
пышность	мичлун
пядь	весьт
пята	
пятачок	
пятиугольник	витсэрӧг
пятка	исип
пятница	пекнича
раб	вер
раб	кесъялысь
работа	удж
работник	уджалысь
работяга	иж.разг.
рабство	кесъялӧм
равенство	ӧткодьлун
равнение	вӧтчӧм
равновеликость	ӧтыдждалун
равновесие	ӧтвесьталун
равнодушие	веськодьлун
равномерность	ӧткодьлун
рагу	рагу
радар	радар
радий	радий
радикализм	
радио	радио
радиобиология	радиобиология
радиоволна	радиогы
радиола	радиола
радиопередача	радиопередача
радиоприёмник	радиоприёмник
радиосвязь	радиойитӧд
радиостанция	радиостанция
радиостудия	радиостудия
радиотелеграф	радиотелеграф
радиотелефон	радиотелефон
радиотехник	радиотехник
радиотехника	радиотехника
радиоэлектроника	радиоэлектроника
радуга	ӧшкамӧшка
разбивка	садитӧм
разбивка	нюжӧдӧм
разбойник	рӧзбойник
разборчивость	гӧгӧрвоӧм
разбрызгивание	резӧм
разбрызгиватель	резан
развал	киссьӧм
разведение	сывдӧм
разведение	рӧдмӧдӧм
разведка	разведка
разведчик	разведчик
разветвление	вожалӧм
разветвление	юкӧн
развилина	вож
развилина	вожаланін
развлечение	гаж
разводка	костӧдӧм
разводье	ры
разврат	мывкыдтӧммӧм
развратность	мывкыдтӧмлун
развращение	тшыкӧдӧм
развязка	пом
развёрстка	юклӧм
развёртывание	паськӧдӧм
развёртывание	паськалӧм
разгадка	тӧдӧм
разгадчик	тӧдмалысь
разгадывание	тӧдмалӧм
разгиб	кусыньтчӧмин
разглагольствование	лавгӧм
разговенье	уллюнйӧссьӧм
разговорчивость	варовлун
разговорчик	
разграбление	грабитӧм
разгрузка	ректӧм
раздвоение	вож
раздевалка	пӧрччысянін
раздевальня	пӧрччысянін
раздевание	пӧрччысьӧм
раздевание	пӧрччӧдӧм
раздел	юкӧд
разделка	серӧдӧм
раздорожье	туйвеж
раздувание	пӧльтӧм
разжива	
разжива	овмӧдчӧм
раззолоченность	зарниалӧм
разлапистость	пашкырлун
разлетайка	повӧй
разливание	кисьталӧм
разлиновка	визьйӧдлӧм
различение	торйӧдӧм
различие	торъялӧм
разложение	торйӧдӧм
разложение	кисьтӧм
разложение	сісьмӧм
разлом	потӧм
разлом	чегӧм
размазня	
размазня	алямазга
разматывание	разьӧм
размах	шен
размашистость	паськыдлун
размер	муртас
размораживание	сывдӧм
размотка	разьӧм
размыв	кырӧм
размыв	кырӧмин
размыкание	орӧдӧм
размычка	орӧдӧм
размягчение	небзьӧдӧм
разнарядка	нарад
разница	торъялӧм
разница	коляс
разноголосица	
разность	торъялӧм
разность	коляс
разносчик	паськӧдысь
разогрев	шонтӧм
разорительность	рӧзӧритӧм
разработка	перъянін
разрежение	кизьӧрмӧм
разрезывание	кырышталӧм
разруха	киссьӧм
разрыхление	небзьӧдӧм
разрыхление	небзьӧм
разрыхлитель	небзьӧдысь
разрядка	бурмӧдӧм
разухабистость	
разухабистость	кыпыдлун
разучивание	велӧдӧм
разъезд	туйвеж
разъяснение	тыдовтчӧм
рай	рай
район	район
район	ин
район	
райцентр	юрсикт
ракетка	ракетка
раковина	ракпань
ракурс	видзӧдлас
рало	гор
ральник	амысь
рама	ӧшинь
ранг	чин
рандеву	аддзысьлӧм
рапира	рапира
раса	раса
раскат	шыбӧль
раскатистость	гылыдлун
раскачивание	легзьӧм
раскачивание	ызйӧм
раскачка	
раскачка	легзьӧдӧм
раскачка	катласьӧм
раскладка	юклӧм
раскладка	пестӧм
раскладка	вольсалӧм
раскладывание	тэчӧм
расклёпка	плавкӧстӧм
раскол	поткӧдлӧм
раскол	юксьӧм
раскопка	кодйысьӧм
раскормка	тшӧгӧдӧм
раскрой	шӧралӧм
раскулачивание	кулакалӧм
раскупорка	восьтӧм
раскуривание	куритчӧм
распивание	юӧм
распил	
распил	вундас
распиловщик	пилитчысь
расписка	гижсьӧг
расплав	сылӧмтор
расплод	чужӧг
расплывчатость	рудӧблун
расплывчатость	гудырлун
распознавание	тӧдмалӧм
распространение	паськалӧм
распряжка	лэдзалӧм
распрямление	веськалӧм
распутье	туйвеж
распущенность	лэдзчысьӧм
распылённость	поснялӧм
распылённость	разалӧм
распялка	зэвтӧс
распятие	шергӧдӧм
рассада	рӧсада
рассадник	вирич
рассеивание	кӧдзӧм
рассеивание	бырӧдӧм
расселина	сёртас
рассеянность	вунӧдчӧм
рассказ	висьт
рассол	рӧсов
расспрашивание	юасьӧм
расспрашивание	юасьӧм
расспросы	юасьӧм
рассредоточение	разӧдӧм
расставка	паськӧдӧм
расстилка	вольсалӧм
расстрел	лыйлӧм
растворитель	сывдысь
растение	быдмӧг
растительность	быдмӧгъяс
растительность	юрси
растление	
растопка	ломзьӧдӧм
растопка	ломзьӧдчан
растрата	растрата
раструб	пасьёв
растрёпа	иж.прост.
растрёпа	
растяжение	нюжӧдӧм
растяжение	нюжалӧм
расхищение	гусявлӧм
расход	видзӧм
расцветка	сер
расценка	дон
расчёска	сынан
расчёт	пӧльза
расшивка	резьӧдӧм
расшивка	вышивайтӧм
расширение	паськӧдӧм
расширение	паськалӧм
расщелина	сёртас
ратинирование	ныалӧм
ратификация	вынсьӧдӧм
ратник	воин
рать	
рать	войска
рационализм	рационализм
рвота	вос
реализация	
реализация	иналӧм
ребро	ордлы
ребус	гӧгӧрвотӧмтор
ребячество	челядьдыр
ребячество	челядясьӧм
ребёнок	кага
ревень	ревень
ревматизм	ревматизм
ревнивец	вежӧгтысь
револьвер	револьвер
революционерка	революционерка
ревун	бӧрдысь
редакторство	редакторалӧм
редакция	редакция
редис	редис
редиска	редиска
редупликация	кывпӧвсталӧм
редут	редут
редька	кушман
реестр	лыддьӧг
режим	ног
режиссура	режиссёралӧм
режиссура	режиссёръяс
режиссёр	режиссёр
режиссёрство	режиссёралӧм
резвость	визувлун
резвун	вильышпоз
резекция	вундӧм
резина	резина
резинка	вуштан
резолюция	резолюция
резус	
резь	орйӧдлӧм
рейсмус	гижта
река	ю
реквизит	кӧлуй
реквизиция	мырддьӧм
рекогносцировка	
рекогносцировка	туялӧм
рекомендация	сӧвет
рекордист	
рекрут	рекрут
ректор	ректор
ректорство	ректоралӧм
реликвия	юрбитантор
рельеф	мыльк
рельс	рельс
релятивность	мыетшлун
ремарка	пасйӧд
реминисценция	
ремитент	
рентген	рентген
репа	сёркни
репейник	
репетиция	репетиция
реполов	пышкай
репорт	
репортаж	репортаж
репрезентация	петкӧдлӧм
репродуктор	репродуктор
репродукция	рӧдмӧдӧм
республика	республика
ресторан	ресторан
ретивое	сьӧлӧм
ретро	
ретро	важся
рефакция	
рефлектор	рефлектор
рефракция	
рефрен	мӧдпӧлалӧм
рефрижератор	кӧдзӧданін
рецидив	
решение	шуӧм
решение	кывкӧртӧд
решето	пож
решительность	повтӧмлун
решётка	тас
решётка	
ржавление	сімӧм
ржавчина	сім
риза	
рис	рис
риск	лысьтӧдчӧм
рисунок	рудӧб
рисунок	сер
рифление	сарӧгалӧм
рифма	ӧттор
рифмовка	ӧтгоралӧм
рог	сюр
рог	буксан
рог	вож
рогатина	шы
рогатина	койбедь
рогатка	утшыс
рогатка	вожка
рогач	укват
рогожа	рӧгӧза
родимчик	рӧдимеч
родина	чужанін
родитель	бать
родительница	мам
родник	ключ
роение	поздысьӧм
рождество	Рӧштво
рожок	буксан
рожок	пуртӧс
роза	роза
розга	ньӧр
розетка	розетка
рознь	
розыгрыш	пудъялӧм
рой	котыр
рол	
рол	
ролик	тюрик
ромашка	катшасин
ромб	ромб
ронжа	кеня
ронжа	ромшина
роса	лысва
роскошь	красуйтчӧм
росплывь	моль
роспуск	бырӧдӧм
россыпь	
рост	быдмӧм
рост	туша
рост	прӧчент
росток	
росянка	лысватурун
рот	вом
рот	сёйысь
рота	рота
роща	рас
рояль	рояль
рубанок	струж
рубашка	дӧрӧм
рубашка	кыш
рубеж	су
рубеж	суйӧр
рубрика	юкӧд
ругатель	
рудимент	коляс
рука	морт
рукав	сос
рукав	полой
рукав	шланг
рукавица	кепысь
руководство	индӧд
рукопись	рукопись
рукопожатие	киасьӧм
рулет	рулет
рулетка	рулетка
рулон	гӧрддзым
русификация	рочмӧдӧм
ручка	вуг
ручка	ручка
рыба	чери
рыба	пӧрйӧг
рыбачка	
рыбник	черинянь
рыганье	горзялӧм
рыжик	аньпель
рыльце	ныр
рыльце	сюр
рысёнок	вӧрканьпи
рыхление	небзьӧдӧм
рыцарство	рыцаръяс
рычаг	вороп
рюмка	румка
рябчик	сьӧла
рябь	сер
рябь	вералӧм
рявканье	равзӧм
ряд	рад
ряженье	
ряженье	вӧччӧдӧм
сабантуй	гажӧдчӧм
сабля	сабля
сад	сад
садок	садӧк
сажа	са
сажальщик	пуктасьысь
сазан	сазан
сайра	сайра
саксофон	саксофон
салага	
саламата	саламат
салат	салат
салон	салон
салфетка	салфетка
сальник	сальник
салют	салют
самбо	самбо
самовар	самӧвар
самовольщик	
самодержавие	самодержавие
самодеятельность	самодеятельносьт
самокат	самокат
самолов	самолов
самооплодотворение	
самосев	
самосогревание	шоналӧм
самосознание	асвежӧртӧм
самостоятельность	асшӧрлун
самоудовлетворенность	дӧвӧльлун
самоуправец	асвӧляасьысь
самоучка	
самоучка	
самоучка	аснаукӧн
самочувствие	аскылӧм
санаторий	санаторий
сандвич	сандвич
санитар	санитар
санитарка	санитарка
санкция	дзескӧдӧм
санскрит	санскрит
сантехник	сантехник
сантиметр	сантиметр
сапёр	сапёр
саранча	саранча
сарафан	шушун
сарделька	сарделька
сарыч	тӧвбергач
сатин	сатин
сатира	сатира
сатурация	болльӧдӧм
сафари	
сафари	сафари
сахар	сакар
сахар	сакар
сбавка	
сбивание	тувъялӧм
сближение	тӧдмасьӧм
сближенность	матыслун
сбор	сорлалӧм
сбор	ӧктас
сборище	
сборник	ӧктӧд
сборщик	тэчысь
сбрасывание	чинтӧм
свалка	чукӧр
сварливость	зьваглун
сварщик	пузьӧдчысь
сват	сват
сватья	сваття
сваха	корасьысь
свая	свая
сведение	юӧр
сведение	тӧдмӧг
свежевание	кульӧм
свежесть	свежӧйлун
свежесть	сӧстӧмлун
свежесть	сӧдзлун
свершение	вӧчӧм
сверщик	прӧверитысь
светильник	лампа
светильня	лампа
светлица	горнича
светлость	югыдлун
свеча	сись
свидетельство	видлалӧм
свинство	
свистун	
свистун	сяквар
свитер	свитер
свищ	розь
свод	свод
сводка	кералӧм
сводник	гозйӧдысь
сводничество	гозйӧдӧм
своеобычность	
своеобычность	
связь	йитчӧм
связь	йитӧд
святитель	вежа
святоша	
святыня	вежатор
священник	поп
свёкла	свеклӧ
свёкор	айка
свёртывание	рысьмӧм
сгон	вӧтлӧм
сгонка	
сгонка	уськӧдӧм
сгорание	сотчӧм
сгуститель	
сгуститель	сукмӧдысь
сгущённость	суклун
сгущённость	тшӧкыдлун
сдача	сдайтӧм
себестоимость	асдон
севрюга	севрюга
сегмент	сегмент
седалище	пуклӧс
седловка	пуклӧсалӧм
седок	верзьӧма
седость	дзорлун
седёлка	седелка
секира	чер
секретариат	секретариат
секта	секта
сектант	сектаса
сектор	юкӧн
сектор	сектор
секунда	секунда
секундант	секундант
секция	секция
селезёнка	лоп
селектор	селектор
село	сикт
селфи	ачпас
сельдь	сельди
селёдка	сельди
семантика	
семантика	
семантика	вежӧртас
семафор	семафор
семейство	семья
семенник	
семерик	
семинар	семинар
семинария	семинария
семиугольник	сизимсэрӧг
семья	котыр
семя	кӧйдыс
семя	семечки
семёрка	сизим
семёрка	сизима
семёрка	сизимӧд
сенат	сенат
сенатор	сенатса
сено	турун
сентиментализм	норлун
сепарация	торйӧдӧм
сера	тэг
сердцевина	пытшкӧс
серебро	эзысь
серебряник	эзысьтысь
серединка	пытшкӧс
середняк	шӧркоддьӧм
сержант	сержант
серия	серия
сермяга	
сермяга	сукман
серость	рудлун
серп	чарла
серпантин	серпантин
сертификат	
сертификат	сертификат
серьёзность	тӧлкалун
серёжка	
серёжка	коль
сестра	манакиня
сестрица	чоюк
сетка	сетка
сеточка	сысъялан
сеть	вез
сеть	вез
сеяльщик	кӧдзысь
сеяльщик	порталысь
сеятель	
сеятель	кӧдзысь
сжатость	дженьыдлун
сжатость	топыдлун
сжим	тшемилӧ
сигнал	сигнал
сидение	пукалӧм
сидень	седун
сила	вын
сила	вын
силос	силос
симпатия	мусук
симпозиум	симпозиум
синдикат	синдикат
синева	лӧз
синтаксис	синтаксис
синтетика	
синус	синус
синхрония	
синь	
синька	лӧзӧдӧм
сирень	сирень
система	тэчас
система	инас
ситец	ситеч
сито	пож
сказ	висьт
сказание	висьт
сказуемое	юӧрпас
скакание	чеччалӧм
скамейка	лабич
скарлатина	скарлатина
скатерть	пызандӧра
скатка	гындӧм
скаут	скаут
скачок	чеччыштӧм
скважина	син
сквер	сквер
скверность	лёклун
скверность	лёктор
скидка	шыблалӧм
скипидар	скипидар
скит	скит
складень	куснясян
склеп	дзебсянін
скоба	скоба
скоба	вуг
скобель	гогын
скол	
скольжение	исковтӧм
скольжение	вежласьӧм
скончание	пом
скопище	
скопище	чукӧр
скорбь	
скорбь	висьӧм
скорлупа	кыш
скороспелка	
скорость	ӧд
скороход	
скотобойня	начкысянін
скрепа	йитлӧг
скрепка	кутӧг
скрепление	кутӧд
скрещение	кресталӧм
скрещение	сорлалӧм
скрипение	дзуртӧм
скрипка	скрипка
скрупулёзность	стӧчлун
скручивание	гартӧм
скручивание	гаровтӧм
скручивание	кӧрталӧм
скряжничество	жмитуналӧм
скудность	жеблун
скудность	гӧльлун
скудность	кушлун
скульптор	сёртысь
скульптура	скульптура
скулёж	никсӧм
скупка	ньӧбалӧм
слагаемое	содтан
слагаемое	юкӧн
слаженность	ладмӧм
слайд	слайд
сланец	сланеч
слегка	
следование	мунӧм
следование	вӧтчӧм
следователь	юасьысь
следопыт	туясьысь
слежка	кыйӧдчӧм
слеза	синва
слеза	бӧрдӧм
слепень	лӧдз
слепок	лапӧг
слесарь	слесар
слива	слива
сливальник	дар
слизняк	лёльӧ
слизь	улим
слизь	неджӧг
слияние	ӧтлаасьӧм
слияние	ӧтлаасянін
словарь	кывчукӧр
слово	кыв
слово	сёрни
словоохотливость	варовлун
словопрение	вензьӧм
словцо	кыв
слом	косялӧм
слом	чегӧмин
слон	слӧн
слонёнок	слӧнпи
служащий	чина
служба	кесъялӧм
служба	служба
служение	служитӧм
случайность	виччысьтӧмтор
слушание	кывзӧм
слушатель	кывзысь
слушатель	велӧдчысь
слюда	миса
слюна	дуль
смазка	мавтас
смазчик	мавтчысь
смак	
смак	ёсьлун
смелость	повтӧмлун
смена	вежысь
смена	вежсьӧг
сменщик	вежысь
смертность	кулалӧм
смерть	пом
смерть	
сметана	нӧк
смех	серам
смехота	теш
смешанность	сораслун
смешинка	серам
смирение	рамлун
смола	сир
смолистость	сирӧдлун
смородина	сэтӧр
смыкание	куньӧм
смыкание	йитӧм
смысл	вежӧртас
смысл	мог
смысл	пӧльза
смычок	вудж
смягчение	небзьӧм
снабжение	могмӧдӧм
снадобье	бурдӧдчантор
снаряд	снаряд
снаряжение	кӧлуй
снасть	кӧлуй
снег	лым
снегирь	жонь
снеговик	лымморт
снежница	
снижение	лэдзчӧм
сновалка	пансян
сновальщик	пансьысь
снование	пансьӧм
сноп	кольта
сноп	сюръя
сноха	монь
собака	пон
собачник	
собачник	
собеседник	вомъёрт
собиратель	чукӧртысь
соболь	низь
собор	чукӧртчӧм
собрат	уджъёрт
собственность	эмбур
сова	сюзь
советник	сӧветник
совещание	сӧвещанньӧ
совик	парка
совок	тэльӧб
совокупление	
совхоз	совхоз
совёнок	сюзьпи
согласование	сёрнитчӧм
согласование	ладмӧдчӧм
соглашательство	унькиасьӧм
согревание	шонтӧм
содействие	отсӧг
содержание	видзӧм
содержание	юриндалысь
содержание	кутӧм
содружество	
содружество	ӧтув
соединение	йитвеж
соединение	ӧтулов
соединение	йитчӧг
сожжение	сотӧм
создание	вӧчӧм
создатель	
создатель	Ен
созерцание	
созерцание	видзӧдӧм
сознание	мыв
сознательность	мыв
созыв	чукӧртӧм
соискание	шедӧдӧм
сок	сӧз
сокол	варыш
соколёнок	варышпи
сокращение	дженьдӧдӧм
сокращение	дженьдаммӧм
сокращение	чинӧм
сокрытие	дзебӧм
солдатня	салдатъяс
солдатчина	салдаталӧм
соление	солалӧм
солнечность	шондіалун
солнце	Шонді
солодка	солодка
солома	идзас
соль	сов
солянка	солянка
солёность	солалун
солёность	солалӧм
сом	сом
соната	соната
сонет	сонет
сообщение	юӧр
сооружение	стрӧйба
сопение	нускӧм
сопение	сургӧм
соперничество	мырддьысьӧм
сопка	мыльк
сопоставление	ӧтластитӧм
сопрано	
сопровождение	ӧтлаасьӧм
сопровождение	йитчӧм
сопротивление	водзсасьӧм
сопряжение	йитӧм
сопутствие	коллялӧм
сор	ёг
сорванец	вильышпоз
соринка	ёгтор
сорняк	ёгтурун
сорока	катша
сорока	сярган
сорочка	дӧрӧм
соска	нёнь
соскок	чеччыштӧм
сословие	сословие
сосна	пожӧм
сосредоточение	ӧтвывтӧм
состав	состав
составитель	лӧсьӧдысь
состояние	лыддьысьӧм
состоятельность	озырлун
сосуд	доз
сосуд	сӧн
сосун	нёньпом
сотворение	вӧчӧм
сотка	
сотня	сёа
соус	соус
соха	гӧр
сохранение	видзӧм
сохранение	кольӧм
социализм	социализм
социология	социология
социум	йӧзкотыр
сочень	сӧчӧн
сочинение	лӧсьӧдӧм
сочинитель	гижысь
сошник	амысь
соя	соя
спад	усьӧм
спазм	
спазм	гӧрддзасьӧм
спайка	спой
спайка	спояйтӧм
спайка	спояйтчӧм
спаньё	узьӧм
спаривание	кыпалӧм
спартакиада	спартакиада
спасание	мездӧм
спасатель	мездысь
спасение	мездӧм
спасение	видзӧм
спасение	мездысьӧм
спаситель	Мезӧс
спектакль	спектакль
спектр	
сперма	сперма
сперматозоид	сперматозоид
специализация	специализируйтӧм
специализация	специализируйтчӧм
специальность	уджсикас
спешка	
спешка	тэрмасьӧм
спид	спид
спинка	бӧр
спираль	гартлӧс
спиритизм	спиритизм
спирт	спирт
спиртовка	спиртовка
списание	мездӧм
спихивание	сюйыштӧм
сплетение	кыӧм
сплетение	кысьӧм
сплотка	
сплотка	топӧдӧм
сплотка	пуръялӧм
спокойность	лӧньлун
споласкивание	пожйыштӧм
сползание	шыбӧлитӧм
спорт	спорт
спортсмен	спортсмен
спортсменка	спортсменка
способ	ног
спрашивание	юалӧм
спринт	спринт
спринцовка	спринцовка
спрос	юалӧм
спряжение	
спрямление	веськӧдӧм
спуск	лэдзӧм
спуск	лэччӧм
спуск	усьӧм
спуск	пезьдӧдан
спутник	спутник
сравнение	орччӧдӧм
срастание	йитчӧм
сращение	
сращение	ӧтлаасьӧмтор
срез	вундӧм
срез	вундас
сретение	Сретенньӧ
сруб	сруб
срыв	орӧдӧм
срыв	торксьӧм
срыгивание	быликтӧм
ссаживание	чеччӧдӧм
стабилизатор	стабилизатор
стадион	стадион
стажировка	стажируйтчӧм
стакан	стӧкан
стамеска	стамеска
станция	станция
старейшина	старейшина
старение	пӧрысьмӧм
старик	пӧль
старинность	важсятор
старовер	
стартер	стартер
старшина	старшина
статистика	статистика
статус	статус
статуэтка	статуэтка
статуя	статуя
стезя	туй
стекание	визувтӧм
стекло	стеклӧ
стеллаж	джадж
стельность	тыр
стена	от
стена	берд
стенгазета	стенгазет
стенд	стенд
стенограмма	стенограмма
степень	пӧвъёвтӧм
степень	тшупӧд
степь	степ
стерва	пежпоз
стереометрия	стереометрия
стереотип	стереотип
стержень	за
стеснение	дзескӧдӧм
стеснённость	дзескалӧм
стилизация	стилизация
стилистика	стилистика
стимулятор	стимулятор
стипендия	стипендия
стихотворение	кывбур
стоимость	дон
столбик	сувтсӧг
столетие	нэм
столица	юркар
столовая	столӧвӧй
стоматология	стоматология
сторона	бок
сторона	му
сторона	бок
сторона	видзӧдлас
стояние	сулалӧм
стоянка	сувтланін
стоянка	сулаланін
страж	
стражник	видзысь
страница	листбок
страница	кадколаст
странник	
стратег	стратег
страус	страус
страх	
страхование	страхуйтӧм
страхователь	страхуйтчысь
стрекоза	вертолёт
стрекот	чирксьӧм
стрекотание	
стрела	ньӧв
стрела	стрела
стрелка	стрелка
стрелок	лыйсьысь
стрельба	лыйсьӧм
стремление	веськӧдӧм
стремя	стремена
стрептококк	стрептококк
стрижка	шырӧм
строгость	чорыдлун
строгость	стӧчлун
строение	стрӧйба
строение	тэчас
стройка	стрӧитчӧм
стройка	стрӧитчанін
строфа	строфа
стружка	стружитчӧм
струйка	визлас
струна	вез
струп	лӧм
стручок	пуртӧс
струя	ва
студент	студент
студентка	студентка
студенчество	студентъяс
студенчество	студенталӧм
студия	студия
ступа	гыр
ступица	трубича
стыд	яндзим
стыдливость	яндысьӧм
стык	йитвеж
стыковка	йитчӧм
стыковка	йитӧм
стюард	бортпроводник
стюардесса	бортпроводнича
стяг	дӧрапас
стягивание	чукӧртӧм
стягивание	зэлалӧм
стягивание	чукӧртчӧм
стёклышко	стеклӧтор
стёсывание	лӧсалӧм
суббота	субӧта
субботник	субӧтник
субъективист	субъективист
сугроб	тола
судорога	войтӧв
судьба	
суживание	векньӧдӧм
сук	ув
сукно	ной
сула	бедь
сулема	сулема
султан	султан
сумасбродство	йӧйталӧм
сумка	сумка
сумма	сьӧм
сумма	сумма
сумрачность	букыдлун
сундук	тылӧс
суп	шыд
супоросность	тыр
супруг	верӧс
супруг	гозъя
супруга	гӧтыр
сургуч	сургуч
сурепица	
сурепица	
суровость	кӧдзыдлун
суровость	сьӧкыдлун
суровость	чорыдлун
сусек	йӧртӧд
суслик	
сусло	чужва
сутулость	мышкырлун
суфле	суфле
суффикс	суффикс
сухощавость	косньӧдлун
сучение	путшкӧм
сучковатость	увйӧсьлун
сучкоруб	увйысьысь
сушение	косьтӧм
сушение	косьмӧм
сушилка	косьтысянін
существительное	эмакыв
существование	олӧм
сфера	гӧгӧртас
сфинкс	сфинкс
схема	схема
сход	лэччӧм
сход	лэччанін
сходность	ӧткодьлун
сходство	ӧткодьлун
сцеживание	сысъялӧм
сцена	лоӧмтор
сценарий	сценарий
сцеп	
сцепление	чукӧр
счастье	шуд
счетоводство	тшӧтӧводство
счёт	тшӧт
счётчик	лыддьысь
счётчик	счётчик
съём	босьтӧм
съёмка	снимайтӧм
сыворотка	рысьва
сыворотка	сыворотка
сын	пи
сыр	сыр
сыроежка	уртшак
сыч	сюзь
сюжет	сюрӧс
сюита	сюита
сюрприз	виччысьтӧмтор
сюртук	сюртук
табак	табак
табак	табак
табачница	
табель	табель
табор	табор
табу	
табу	олӧм
таволга	лобоз
тавро	пасъян
таинственность	гусятор
такелаж	
такси	такси
таксофон	таксофон
талант	енби
талия	кос
талон	талон
тальк	тальк
тальник	бадь
тальянка	таллянка
таможенник	таможняса
тангенс	тангенс
танго	танго
танкист	танкист
танцор	йӧктысь
танцплощадка	йӧктанін
таракан	тӧрӧкан
таран	йиг
татуировка	бытшкалӧмин
тать	гусясьысь
татьба	гусясьӧм
таяние	сылӧм
тварь	пемӧс
твердыня	изкар
твердь	
творец	
творец	ен
творчество	творчество
твёрдость	чорыдлун
твёрдость	зумыдлун
тезаурус	кывчукӧр
тезис	тезис
тезоименитство	нимлун
текстильщик	кыысь
тектоника	
телевидение	телевиденньӧ
телега	телега
телеграмма	телеграмма
телеграф	телеграф
телекс	телекс
телестанция	телестанция
телестудия	телестудия
телетайп	телетайп
телефакс	телефакс
телефон	телефон
телефонист	телефонист
телецентр	телецентр
тело	телӧ
телохранитель	видзысь
тельник	
тельник	перна
темень	пемыд
темнота	пемыд
темнота	пемыдлун
темп	ӧд
температура	температура
теннис	теннис
тень	вуджӧр
тень	мыгӧр
тень	сайӧд
тенёта	казь
теорема	теорема
теория	теория
теория	видзӧдлас
теплица	теплича
тепловоз	тепловоз
теплоход	теплоход
теплушка	
терапия	
теребление	нетшкӧм
термин	термин
термос	термос
терние	
терпение	терпенньӧ
терпимость	терпитӧм
терпимость	лэптӧм
терраса	тшупӧд
террористка	террористка
тесание	лӧсалӧм
теснение	топӧдӧм
теснота	дзескыдлун
теснота	дзескыдін
тетерев	тар
тетеря	
тетива	вез
тетрадь	тетрадь
тетёрка	
техник	техник
техника	техника
техникум	техникум
технократ	технократ
технолог	технолог
течение	визувтӧм
течение	визь
тигр	тигр
тигрёнок	тигрпи
тильда	тильда
тип	сикас
тип	морт
типаж	сикасъяс
типология	сикаслун
тиражирование	лыдмӧдӧм
тиран	тиран
тире	тире
тихоход	
тишь	
ткань	
тканье	кыан
тлен	
тмин	тмин
товарищ	ёрт
товарищество	ёртасьӧм
товарищество	лӧсялӧм
товарищество	котыр
товаровед	тӧваровед
тождественность	ӧткодьлун
тождество	ӧткодьлун
токарь	токар
токование	койтӧм
толкователь	гӧгӧрвоӧдысь
толкучка	
толща	джуджда
толща	кызта
толща	пытш
толь	толь
том	том
томительность	ониш
томление	пожӧм
томность	нярмыдлун
тон	шы
тон	сёрнитанног
тон	рӧм
тональность	
тонирование	
тонирование	рӧммӧдӧм
тонна	тонна
тонус	ыззьӧм
тоня	тӧня
топаз	топаз
топограф	топограф
топография	топография
топор	чер
торба	зӧбня
торбаса	пими
торг	донъясьӧм
торг	базар
торг	тӧрг
торгаш	вузасьысь
торец	бокладор
торжественность	кыпыдлун
торжество	кыпыдлун
торжище	вузасянін
торопливость	тэрыблун
торошение	тӧрӧгалӧм
торпеда	торпеда
торпедист	торпедист
торт	торт
торшер	торшер
тоталитарность	ыджыдалӧм
точилка	ёсьтан
точность	стӧчлун
трава	турун
травматизм	доймалӧм
травмирование	дойдӧм
травмирование	дойдӧм
травостой	турунзьӧм
трагедия	трагедия
трагизм	трагизм
трагикомедия	трагикомедия
традиционность	важсялун
тракт	тракт
трактат	
трактование	
трактование	видлалӧм
трактор	трактор
тракторист	тракторист
трактористка	трактористка
трал	
тральщик	
трамбовка	
трамбовка	чокмар
трамвай	трамвай
трамплин	трамплин
транзистор	транзистор
транс	
транскрипция	
трансляция	транслируйтӧм
трансляция	транслируйтантор
трансмиссия	трансмиссия
транспорт	транспорт
транспортирование	колльӧм
трансформатор	трансформатор
трап	пос
трапеция	трапеция
трасса	туй
трата	видзӧм
трахея	сераголя
треба	
трезвость	палялӧм
тренога	
трепальня	нирасянін
трепальня	летчанін
трепальщик	нирасьысь
трепание	ниралӧм
трепание	летӧм
трепло	
трепло	
треска	треска
трескотня	
трест	трест
треугольник	куимсэрӧг
трещина	торксьӧм
трибуна	трибуна
тригонометрия	тригонометрия
трико	
трикотаж	кыӧмтор
трикотажник	кысьысь
триптих	
трифоль	кадвуж
трихина	ков
тройка	куим
тройка	куимӧн
тройник	тройник
троллейбус	троллейбус
тромб	
тромб	суктас
тромбон	тромбон
тропик	тропик
тростник	тростник
трость	бедь
тротуар	моски
труба	труба
труба	труба
труба	
трубка	каллян
трубка	трубка
трубопровод	трубопровод
труд	удж
труд	удж
труд	уджалӧм
трудодень	уджлун
труженик	уджалысь
труженичество	уджалӧм
труп	шой
труха	ковтӧмтор
трюмо	трюмо
тряпьё	
тряска	бергӧдлӧм
трясогузка	сырчик
трёпка	
трёпка	торшӧдлӧм
туберкулёзник	
туес	туис
туз	туз
туз	туз
тулья	лыбӧд
туман	гудыр
туманность	гудыртчӧм
туманность	гудыр
тунец	тунеч
туннель	туннель
турбаза	турбаза
турбина	турбина
туризм	туризм
тучность	тшӧглун
тучность	вын
тучность	улислун
тучность	шаньлун
туш	туш
туша	туша
тушь	туш
тушёвка	визьяс
туя	туя
тыква	тыква
тыл	тыл
тысячелетие	сюрсво
тысячелистник	кӧртдой
тычок	
тюбетейка	тюбетейка
тюбик	тюбик
тюль	тюль
тюльпан	тюльпан
тюркология	тюркология
тюфяк	перина
тягость	мудз
тягучесть	нюдзлун
тягучесть	суклун
тяж	
тяж	тасма
тяж	йитлӧс
тяж	сӧн
тяжба	судитчӧм
тяжесть	сьӧкыдлун
тяжесть	сьӧкыд
тяпка	кокан
тёлка	
тёмная	пемыдін
тёс	тьӧс
тёска	лӧсалӧм
тёща	тьӧща
убаюкивание	такӧдӧм
убиение	виӧм
убогость	жеблун
убожество	коньӧрлун
убожество	жеблун
убранство	мичмӧдӧм
увал	нырӧк
увековечение	нэммӧдӧм
увеличение	ыдждӧдӧм
уверение	эскӧдӧм
увертюра	увертюра
увеселитель	гажӧдысь
увесистость	сьӧкыдлун
увечье	доймӧм
увлечение	кыпыдлун
увлечение	ылалӧм
увоз	нуӧм
увольнение	лэдзӧм
угар	кольмӧм
угасание	кусӧм
углевоз	
углекислота	углекислота
углерод	углерод
углублённость	джудждаммӧм
углублённость	содӧм
угнетение	пӧдтӧм
уговор	
уговор	сёрнитчӧм
угол	пельӧс
угол	пельӧс
уголовщина	
уголок	пельӧс
уголок	пельӧс
уголь	шом
угольщик	
угонка	
удавленник	
удаление	вундӧм
удар	шог
удар	уськӧдчӧм
удар	паралич
ударение	ударенньӧ
удачливость	шудалун
удвоение	кыкпӧвъёвтӧм
удерж	
удобство	лӧсьыдлун
удобство	удобство
удовлетворение	могмӧдӧм
удовлетворение	дӧвӧльлун
удовлетворённость	дӧвӧльлун
удой	лысьтӧм
удостоверение	эскӧдӧм
удостоверение	эскӧданпас
уединённость	йӧзтӧмин
уезд	уезд
ужас	повзьӧм
ужас	
ужесточение	чорзьӧдӧм
узилище	дзескыдін
узнавание	тӧдмалӧм
узнавание	тӧдӧм
узость	векньыдін
указатель	индӧд
указатель	тошъян
указатель	петкӧдлысь
указатель	индалысь
указка	индӧд
укачивание	мудзтӧдӧм
укладка	вольсалӧм
укладчик	вольсалысь
укладывание	вольсалӧм
уключина	ӧключина
укол	укол
укос	
укос	ытшкӧм
укроп	укроп
уксус	уксус
улов	кыйдӧс
улучшение	бурмӧм
улучшение	бурмӧдӧм
улучшение	буртор
умаление	чинтӧм
уменьшаемое	чинтӧс
умеренность	шӧркоддьӧм
умерщвление	виӧм
уместность	лӧсялӧм
умильность	леститчӧм
умирание	кулӧм
умник	
умолот	усьӧм
умонастроение	мӧвпвизь
уморение	тӧмитӧм
умывальня	мыссянін
умыкание	пышйӧдӧм
умысел	план
умягчение	небзьӧдӧм
умягчение	небзьӧм
универмаг	универмаг
универсализм	унасикаслун
университет	университет
унитаз	унитаз
уничтожение	потшӧм
унос	нуӧм
упаковка	тӧбӧд
упитанность	вердаслун
уплотнение	топӧдӧм
уподобление	ӧткодялӧм
уподобление	пӧрӧм
уполовник	дар
упорство	
употребление	сёйӧм
употребление	юӧм
управа	управа
управитель	
управление	веськӧдлӧм
управление	веськӧдлӧм
управляемость	веськӧдлӧм
упражнение	удж
упражнение	турисювтчӧм
упряжка	
упущение	кольӧм
уравнение	ӧткодялӧм
ураган	
уран	уран
урбанизм	
урезка	
урема	войт
урина	кудз
урна	урна
уродство	мисьтӧмлун
уродство	мисьтӧмтор
урок	урок
урядник	урадник
усадьба	усадьба
усач	сиргаг
условие	кесйӧг
условие	подув
условие	мыччӧд
услужливость	кывзысьӧм
усовершенствование	бурмӧдӧм
успеваемость	велалӧм
успение	кулӧм
успение	успенньӧ
успех	вермӧм
установка	установка
установка	нырвизь
установление	сувтӧдӧм
установление	лӧсьӧдӧм
установление	тӧдмалӧм
устарелость	важмӧм
устилка	вольсалӧм
устилка	вольӧс
устройство	тэчасног
устройство	тэчас
уступ	тшупӧд
уступка	сетӧм
устье	вом
усугубление	
усушка	косьмӧм
усыпальница	дзебанін
усыпление	пагӧдӧм
усыпление	ланьтӧдӧм
утайка	
утверждение	вынсьӧдӧм
утепление	шонтӧм
утеря	воштӧм
утеха	
утка	утка
уток	кыан
утоление	веськӧдӧм
утоление	пальӧдӧм
утопист	утопист
утор	джу
уточнение	стӧчмӧдӧм
уточнение	стӧчмӧдантор
утреня	асъя
утро	асыв
утроба	
утряска	ладмӧдӧм
утюг	утюг
утяжеление	сьӧктӧдӧм
утёнок	уткапи
уха	юква
ухарство	удаллун
ухват	укват
ухватка	
ухо	пель
ухудшение	сьӧктӧм
участник	участвуйтысь
участок	юкӧн
ученик	велӧдчысь
училище	училище
учитель	велӧдысь
учительство	велӧдысьяс
учреждение	йӧзкерка
учёба	велӧдчӧм
уширение	паськӧдӧм
уширение	паськыдін
ушко	пыс
ушко	пель
ущемление	топӧдӧм
ущерб	пыдӧс
уяснение	тӧдмалӧм
фабрика	фабрика
фабрикантша	
фабрикантша	
фабула	сюрӧс
фабульность	сюрӧслун
фагот	фагот
фаза	юкӧн
фазан	фазан
фазотрон	ӧддзӧдан
файл	файл
факс	факс
фактура	
фактура	аслыспӧлӧслун
фактура	тэчас
факультет	факультет
фальсификатор	
фальсификация	
фальсификация	пӧрйӧг
фальсификация	лёкмӧдӧм
фальсифицирование	
фальсифицирование	пӧрйӧдлӧм
фальц	йитвеж
фальц	кусынь
фальцевание	куснявлӧм
фальцовщик	куснявлысь
фальшивка	
фальшивка	пӧрйӧг
фамилия	ов
фамилия	семья
фанера	фанера
фант	
фант	пудъясянтор
фантазия	ру
фантазия	фантазия
фантазёр	лӧсьӧдлысь
фантом	
фантом	лӧсьӧдӧмтор
фанфара	фанфара
фарфор	фарфор
фаска	бан
фасоль	фасоль
фашизм	фашизм
фашист	фашист
федерализм	федерализм
федерация	федерация
федерация	котыр
фельдмаршал	фельдмаршал
феномен	
феномен	петкӧдчӧмтор
феодал	феодал
феодализм	феодализм
ферма	ферма
фестиваль	фестиваль
фетр	гын
фиалка	фиалка
фигня	ковтӧмтор
фигура	пертас
фигура	морт
фигуральность	серпаслун
физалис	физалис
физик	физик
физиолог	физиолог
физиономия	
физкультура	физкультура
физкультурник	физкультурник
физкультурница	физкультурнича
фиксация	веськӧдӧм
фикус	фикус
филармония	филармония
филолог	филолог
филология	филология
философия	философия
фильм	фильм
фильтр	фильтр
филёнка	
фимиам	ладан
финик	финик
финифть	финифть
финт	наянитӧм
финтифлюшка	
фирма	фирма
фисгармония	фисгармония
фиск	казна
фисташка	
фитиль	петель
фитюлька	
фламинго	фламинго
фланель	помазея
флегма	
флегма	
флейта	флейта
флокс	флокс
фобия	полӧм
фольга	фольга
фольклор	фольклор
фонарь	пӧнар
фонд	фонд
фонетика	
фонетика	шыкуд
фонтан	дзульк
форейтор	палетур
форма	бала
форма	лу
форма	форма
формалин	формалин
формальность	ноглун
форманта	форманта
формат	ыджда
формирование	котыртӧм
формование	
формовка	лу
формула	формула
формуляр	
формуляр	формуляр
форсирование	ӧддзӧдӧм
фортепьяно	фортепьяно
фосфор	фосфор
фосфоресценция	югзьӧм
фосфорит	фосфорит
фотография	снимайтчанін
фотообъектив	фотообъектив
фотоплёнка	фотоплёнка
фотосинтез	фотосинтез
фрагмент	
фраза	кывйитлӧс
фразеологизм	кывтэчас
фразеология	кывтэчасъяс
фрамуга	фрамуга
фрахт	
фреза	
фрейдизм	фрейдизм
фривольность	
фронт	фронт
фронт	ӧтувтчӧм
фронт	визь
фтор	фтор
фуга	фуга
фугас	фугас
фугование	
фуксия	фуксия
фундаментальность	
функционирование	уджалӧм
функция	функция
функция	удж
фураж	кӧрым
фурункулёз	мылльӧссьӧм
футбол	футбол
футляр	пуртӧс
футуролог	футуролог
халат	халат
халва	халва
халтура	
хаотичность	дзуглун
хариус	ком
харканье	сьӧласьӧм
харчевня	нуръясянін
хвала	
хвала	ошкӧм
хваление	ошкӧм
хвоинка	лыс
хворост	
хвост	бӧж
хвост	бӧж
хвост	ӧчередь
хвостик	идз
хвоя	лыс
химия	химикатъяс
химчистка	
хирург	хирург
хитросплетение	
хитросплетение	наянитӧм
хлад	кӧдзыд
хлам	
хлеб	нянь
хлеб	нажӧтка
хлебец	няньтор
хлебница	
хлеборезка	
хлопец	
хлопотун	ноксьысь
хлопушка	шлачкан
хлопчатник	хлопчатник
хлор	хлор
хлюпанье	
хлястик	клястик
хна	хна
хныканье	
ход	мунӧм
ход	ветлӧм
ход	ӧд
ход	ветланін
ходка	ветлӧм
ходкость	восьлас
хозяин	олыся
хозяйка	ыджыдалысь
хозяйство	овмӧс
хоккей	хоккей
холод	кӧдзыд
холод	кӧдзыдін
холодина	кӧдзыд
холодность	кӧдзыдлун
холодность	видзчысьӧм
холодок	
холодок	ыркыд
холодок	ыркыдін
холодок	йирмӧг
холодрыга	кӧдзыд
холощение	кодзӧм
холст	дӧра
холстинка	дӧра
холуй	
холуй	кесйылӧс
хомут	асык
хомяк	хомяк
хор	хор
хохлатка	
хранение	видзӧм
хранилище	видзанін
хребет	мыш
хрен	хрен
хризантема	хризантема
хрип	киргӧм
христос	кристос
хромирование	
хромка	хромка
хрупкость	жеблун
хрыч	кутш
хрюканье	руксӧм
хрюшка	порсь
художество	художество
худощавость	косньӧдлун
хулиган	кулиган
хулиганка	кулиганка
хулиганьё	кулиганъяс
хунта	хунта
хурма	хурма
хутор	хутор
цапка	кокан
цапля	цапля
царение	сералӧм
царица	сарань
царство	саралӧм
царство	сарство
царство	ыджыдалӧм
царь	медыджыд
цаца	чача
цежение	вийӧдӧм
целина	эжа
целитель	бурдӧдысь
целлофан	целлофан
целлюлоза	целлюлоза
целостность	ӧтторъялун
цель	пас
цель	мог
цельность	ӧтторъялун
цемент	цемент
цементация	цементасьӧм
цементирование	цементируйтӧм
цена	дон
ценз	
ценность	дон
центр	шӧр
центр	шӧр
центр	шӧрин
центрифуга	центрифуга
центрование	
центрование	
цеп	вартан
цепкость	нюдзлун
цепочка	чеп
цесаревич	сарпу
цех	цех
цигарка	чигарка
цигейка	цигейка
цидулька	гижӧдтор
цикорий	цикорий
цилиндр	цилиндр
цинга	цинга
цинк	цинк
циновка	рӧгӧза
цирк	цирк
циркачество	циркасьӧм
цирконий	цирконий
цирюльник	
цирюльник	шырсьысь
цирюльник	бурдӧдысь
цирюльня	шырсянін
цистерна	цистерна
цитадель	изкар
циферблат	циферблат
цифирь	
цифирь	лыдпасъяс
цифирь	арифметика
цифра	лыдпас
цуг	звӧйк
цыганочка	чиганка
цыплёнок	чипанпи
чабер	чабер
чад	кольмӧдантор
чайка	каля
чайник	чайник
чаровник	тӧдысь
час	час
часок	час
частик	
частное	юкбӧр
частота	тшӧкыдлун
частота	топыдлун
частота	суклун
частота	тэрыблун
частотность	тшӧкыдлун
часть	пай
чашка	чашка
чаёвник	чаясьысь
чекан	
чекист	чекист
челнок	
человек	морт
человекодень	мортув
челюсть	
челядь	
чемерица	кӧкакань
чемпион	чемпион
чемпионат	чемпионат
чемпионка	чемпионка
чепе	
чепуха	
червяк	
черепаха	черепаха
черешня	
черканье	
черканье	гижйӧдлӧм
черканье	киритӧм
чернение	сьӧдӧдӧм
чернение	сьӧдӧдӧм
черника	чӧд
черничник	чӧдъяин
чернобурка	
чернота	сьӧдӧб
чернотроп	
черпак	кӧш
чертовщина	
чертёж	чертёж
чертёнок	
черчение	черченньӧ
черёд	кад
черёд	ӧчередь
черёмушник	льӧмъяин
чесальщик	
чесальщик	зуасьысь
чеснок	чеснӧк
чествование	ыдждӧдлӧм
честность	веськыдлун
честь	нывбур
чета	
чета	гозъя
четверг	четверг
четверостишие	нёльвизя
четвертинка	
четвертинка	чекушка
четырёхугольник	нёльсэрӧг
чечевица	чечевича
чешуя	сьӧм
чибис	чибис
чиж	чиж
чирёнок	жыдачпи
число	лыд
чистильщик	весалысь
чистоган	
чистоган	озырмӧдчӧм
чистоплюй	
чистопородность	рӧдвывлун
чистосердечность	веськыдлун
чистота	сӧдзлун
чистота	сэзьлун
чистота	югыдлун
чистота	веськыдлун
читание	лыддьысьӧм
читка	лыддьӧм
чих	несйӧм
член	шлен
член	юкӧд
чрево	
чрево	пытшкӧс
чтение	лыддьысьӧм
чтиво	лыддянтор
чуб	сорс
чувственность	кылӧм
чувствительность	стӧчлун
чувствительность	полӧм
чугун	чугун
чудаковатость	тешкодьлун
чудо	ирел.чудеса
чудо	
чужак	
чум	чум
чума	чума
чуткость	сюсьлун
чуткость	кокнилун
чуткость	стӧчлун
чуточка	
чуточка	войт
чуточка	
чучело	чучела
чёлка	бурысь
чёлка	чолка
чёрточка	визьтор
чёска	
чёска	нистӧм
чёт	тшӧт
чётность	тшӧт
шабашка	
шабашка	вӧчӧмтор
шабашник	шабашник
шаблон	намет
шаблон	бала
шаг	воськов
шайба	шайба
шайба	шайба
шаланда	шаланда
шалфей	шалфей
шаманство	
шампанское	шампанскӧй
шанс	ком
шаньга	шаньга
шапка	шапка
шарада	нӧдӧдчан
шараханье	
шаржирование	
шарик	ёкмыль
шарикоподшипник	шарикоподшипник
шарманка	шарманка
шарнир	дзир
шасси	
шастанье	волькӧдан
шаткость	дзибрӧслун
шатёр	туган
шахтёрка	
шваль	
швальня	вурсянін
швартовка	домасьӧм
швец	вурсьысь
швея	вурсьысь
швыряние	шыблалӧм
шептун	
шероховатость	сарӧгаин
шерсть	вурун
шершавость	сарӧг
шест	бедь
шестиугольник	квайтсэрӧг
шесток	сёр
шестёрка	квайта
шеф	шеф
шеф	юрнуӧдысь
шибай	барышничайтысь
шиворот	шоша
шик	
шикарность	
шило	шыла
шилохвостка	кавкавлык
шимпанзе	шимпанзе
шинель	шынель
шинкарство	
шинкарь	
шинкование	шырӧм
шинковка	шырӧм
шипение	чушкӧм
шипение	вишкӧм
шиповник	лежнӧгйыв
ширма	сайӧд
ширма	сайӧд
широкость	паськыдлун
широта	паськыдлун
широта	пасьта
шитьё	вурсян
шитьё	вышивайтӧм
шифер	шипер
шифр	гусяпас
шифр	индӧдпас
шифровка	гусяпасалӧм
шиш	
шишка	коль
шишка	шмак
шкала	мурт
шкалик	
шкалик	кальчик
шкатулка	куд
шкаф	шкап
шкаф	пач
шкворень	болт
шкив	шкив
шкода	
школа	школа
шланг	шланг
шлейф	пуркйӧг
шлем	шлем
шлея	шлея
шлюз	шлюз
шмель	мазі
шницель	шницель
шнур	кӧв
шнур	провод
шнурование	кӧртавлӧм
шнурование	вурӧм
шов	вурыс
шов	вурыс
шов	йитвеж
шок	шок
шоколад	шоколад
шомпол	шомпур
шоссе	туй
шпага	шы
шпагат	шпагат
шпаклевание	шпаклюйтӧм
шпаклёвка	
шпаклёвка	шпаклюйтӧм
шпаклёвка	шпаклюйтан
шпалера	шпалер
шпаргалка	
шпатель	тэльӧб
шпинат	шпинат
шпионство	шпионалӧм
шпора	шпора
шрам	вурыс
шрифт	гижӧбтас
штаб	штаб
штамп	штамп
штамп	ӧтног
штампование	штампуйтӧм
штанга	штанга
штанга	штанга
штангенциркуль	штангенциркуль
штепсель	штепсель
штифт	тув
штольня	гӧбӧч
штопка	сунис
штора	занавес
штраф	штрап
штриховка	визьйӧдлӧм
штриховка	визьйӧдлӧмин
штука	пома
штукатурка	мавтас
шуба	пась
шубёнка	пасьшой
шулерство	мутлуйтчӧм
шум	шы
шум	шы
шуруп	тшуруп
шурф	шурф
шутка	теш
шушуканье	
шушуканье	тяльскӧдчӧм
шхуна	шхуна
щедрость	лютлун
щекотка	гильӧдӧм
щекотка	гилялӧм
щель	сайӧд
щербина	пинь
щербина	кост
щипание	
щипание	куштӧм
щипание	чӧсӧдӧм
щит	пӧв
щит	щит
щука	сир
щёлк	
щёлк	печик
щёлок	кунва
щёлочь	щёлоч
щётка	щӧтка
щётка	тшӧтки
эвкалипт	эвкалипт
эвристика	
эдикт	
эквивалент	ӧткодьтор
экзамен	экзамен
экзекутор	нӧйтысь
экзекуция	
экземпляр	морт
эконом	
эконом	
экономия	видзтӧм
экскурсия	экскурсия
экскурсия	
экспансия	
экспансия	паськалӧм
экспедитор	
эксплуататор	нартитысь
эксплуатация	нартитӧм
экспозе	
экспроприация	мырддьӧм
экстракция	
эксцентричность	
эксцесс	
эластик	резина
электризация	
электричка	
электровоз	электровоз
электрод	электрод
электромагнит	электромагнит
электроника	электроника
электропечь	электропач
электропоезд	электропоезд
электроскоп	электроскоп
электротехник	электротехник
элита	
эллинг	
эмаль	эмаль
эмпирик	практик
эмпирия	
эмпирия	видзӧдӧм
эмульгирование	
эмульсия	эмульсия
энергетик	энергетик
энергетика	энергетика
эолит	
эпатаж	карапужитчӧм
эпидемия	пӧрӧс
эпидиаскоп	эпидиаскоп
эпизод	вӧвлӧмтор
эпилог	бӧркыв
эпиталама	
эпитет	мичкыв
эрозия	сімӧм
эсер	эсер
эскадра	эскадра
эскулап	бурдӧдысь
эспланада	
эстамп	эстамп
эстрада	брундук
эстрада	эстрада
этажерка	этажерка
этюд	этюд
эфир	эфир
эффект	ворсӧдчӧм
юбка	юбка
юг	лунвыв
юла	дурпоп
юридизация	юридизация
юриспруденция	юриспруденция
юркость	писькӧслун
юрок	пинькай
юстиция	юстиция
ябеда	
ябеда	
яблоня	яблӧгпу
явление	лоӧмтор
явление	петкӧдчӧм
явь	вемӧс
ягодник	вотӧсаин
ядро	ядрӧ
ядро	сьӧмӧс
ядро	сюрӧс
яичница	яеснича
яйцо	
яканье	акайтӧм
якорь	якӧр
яловка	
яма	гу
ямщина	
янтарь	изсир
ярлык	ним
ярмарка	ярманга
ярость	ярлун
ярус	судта
ясновидение	
ясность	дзирыдлун
ясность	ясыдлун
ястреб	варыш
ястребёнок	варышпи
ястык	
ячейка	син
ячейка	ютыртор
ячея	син
ящер	ящер
ёж	ёж
ёрш	йӧрш
автоматизироваться	автоматизируйтчыны
акать	акайтны
аранжировать	инесов.
ахнуть	
бабахать	
бабахнуть	
багрянить	пемыдгӧрдӧдны
баловать	
барахлить	
бастовать	бастуйтны
бдеть	
белить	что
бередить	что
беременеть	сьӧктыны
бешенствовать	яравны
бичевать	кого
благоустроиться	бурмыны
блокировать	инесов.
блудить	
блюсти	
бодаться	люкасьны
болтать	
болтать	
бомбардировать	инесов.
бороздить	что
брехать	
бриться	бритчыны
бросать	что
брызнуть	
брякать	
брякнуть	
будоражиться	шызьыны
бултыхать	
бултыхаться	
бурчать	
буффонить	тешитчыны
бухать	
бухнуть	
бухнуться	
быть	
валандаться	
валом	
вариться	пусьыны
варьироваться	вежласьны
вбивать	что
вбирать	что
ввезти	что
ввернуть	что
ввинтить	винтитны
вдохнуть	что
вековать	нэмуйтны
великодушничать	бурлунасьны
величаться	
вернуть	что
вероятно	
веселеть	гажмыны
веселиться	гажӧдчыны
взбудоражиться	шызьыны
взбухать	польдчыны
взбухнуть	польдны
взбучить	кого
взвеситься	веситчыны
взвести	что
взвинтиться	швыргыны
вздорожать	донсявны
вздумать	
вздуть	что
вздыхать	
взломать	что
взрослеть	верстяммыны
вить	что
вихлять	
вкоренить	что
влечься	кыссьыны
внушать	что
возгордиться	чем
возделывать	что
возложить	что
возможно	
возможно	
возобновить	что
волхвовать	тунавны
ворковать	кургыны
воротить	
ворочаться	
ворошить	что
воскресать	ловзявны
восполниться	вешйыны
воспользоваться	чем
воспроизвести	что
впитать	что
вправить	что
вскинуть	что
вскрыть	что
вспениться	быгзьыны
вспрыскивать	что
вспрыснуть	что
вспухать	пыктавны
вспухнуть	пыктыны
втравить	кого
втянуться	
вшиветь	тойӧссьыны
выбелить	что
выбраниться	ёрччыштны
выбриться	бритчыны
вываляться	туплясьны
выварить	что
вывернуть	что
выветрить	что
выветриться	что
вывихнуться	вӧрзьыны
выворотить	
выгадать	что
выгладить	что
выгладиться	шылявны
выговорить	что
выдавить	что
выдвинуть	что
выделать	что
выделывать	что
выдолбить	что
выдумать	что
выдуть	что
выездить	кого
выесть	что
выжарить	что
выжариться	
выжать	что
вызваться	вӧзйысьны
выкачать	что
выкиснуть	шоммыны
выкладывать	что
выклепать	что
выклюнуть	кокыштны
выколотить	что
выколоть	что
выкоптить	что
выкорчевать	что
выкосить	что
выкрасить	что
выкрикнуть	что
выкристаллизоваться	измармыны
выкрошиться	чирйысьны
выкрутить	что
выкрутиться	
выкупиться	вештысьны
вылакать	что
вылить	что
вылощить	что
вылощиться	дзирдмыны
вылупить	что
вымазать	что
вымарать	что
выматериться	матьӧктыны
вымерзнуть	кынмыны
выместить	что
выметать	что
вымолотить	что
вымотать	
вымотаться	
вынюхать	что
выпарить	что
выпахать	что
выпендриваться	
выпечь	что
выпилить	что
выпить	что
выплакать	что
выплеснуть	что
выполоть	что
выправить	что
выпрыгнуть	чеччыштны
выпрячься	лэдзасьны
выпучить	что
выпятить	что
выработать	что
выразить	что
выровнять	что
вырубить	что
выругаться	ёрччыштны
вырыть	что
вырядиться	вӧччыны
высвистывать	
высечь	что
выскоблить	что
выскрести	что
высморкаться	сульсьыны
высмотреть	что
высосать	что
выставиться	мыччысьны
выстрадать	что
выстрелять	
выстричься	шырсьыны
выстудиться	кӧдзавны
высушиться	косьмыны
высчитать	что
вытереть	что
выткать	что
вытоптать	что
выторговать	что
выточить	что
выхолодиться	кӧдзавны
выцарапаться	
вычитать	что
вышвырнуть	
вялиться	косьмыны
гадить	
газироваться	боллясьны
газифицировать	что
гарантировать	инесов.
гасить	что
гвоздить	что
генерировать	вӧчны
гикнуть	икнитны
глазировать	что
глотать	что
глядеть	
глянуть	видзӧдлыны
гнить	сісьмыны
гоношить	
гоношиться	
городить	что
гостить	гӧститны
грезиться	кому
гримироваться	гримируйтчыны
громоздить	что
грузиться	сӧвтчыны
даться	
двинуть	
двоить	что
дежурить	дежуритны
демаскироваться	эрдасьны
демократизировать	демократизируйтны
демократизироваться	демократизируйтлыны
демонстрировать	инесов.
деморализовать	кого
дешеветь	донтӧммыны
дешевить	донтӧмтыны
диктовать	что
директорствовать	директоравны
дисконтировать	
добавиться	содны
добыть	что
довариться	пусьыны
доглядеть	
доделать	что
доехать	воны
доиться	лысьтыны
доказать	что
докатить	что
долбить	что
доминировать	
домчать	
допечься	пӧжассьыны
дописать	что
дополниться	содны
дорожать	донсявны
достаться	кому
достигнуть	чего
дочистить	что
дошивать	что
драить	что
драматизировать	что
драть	кого
дрейфовать	
дробить	что
дубасить	
думаться	кому
дуреть	
дурить	
дурнеть	мисьтӧммыны
дьяконствовать	дякӧнавны
езжать	
ершиться	
ершиться	
жаднеть	горшмыны
жадничать	горшасьны
жениться	инесов.
жилиться	
жить	овны
жульничать	жульничайтны
заартачиться	дуанитчыны
забелить	что
забухнуть	туктыны
заважничать	тшапмыны
заварить	что
завершить	что
завинтиться	винтитчыны
завить	что
завоевать	что
заволочь	что
завуалировать	что
завязать	что
загаснуть	кусны
загладить	что
заглубляться	джудждӧдчыны
заглушить	что
загноить	что
заголиться	куштысьны
загордиться	тшапмыны
загореть	гожъявны
загородиться	чем
загреметь	
загрызть	кого
загубить	
загуляться	
загустить	что
задать	что
задвинуть	что
заделать	
задерживать	конйӧдлыны
задирать	
задираться	
задёргать	чем
заесть	что
заиграть	что
заикнуться	
заилиться	нюйтӧссьыны
зайтись	
заказать	что
заклевать	кого
заклеиться	лемасьны
заколотить	
заколотить	
закольцевать	кольчаавны
законсервировать	что
закоптить	что
закостенеть	
закруглить	что
закрутить	что
заладить	
зализать	что
залить	что
заломить	что
замазать	что
замениться	вежсьыны
замести	что
замкнуть	что
замлеть	
заморить	
замочиться	кӧтасьны
замусориться	ёгӧссьыны
замутиться	гудыртчыны
замшеть	нитшсявны
замыть	что
замять	что
замяться	
занестись	
заночевать	узьмӧдчыны
заострить	что
запахать	что
запахнуть	что
запечатать	что
записывать	что
заплакать	бӧрддзыны
заполнить	что
заполниться	тырны
заправить	что
заприметить	
запрокинуть	что
запропасть	вошны
запрудить	что
запрудить	тыртны
запрудиться	тырны
запрячься	доддясьны
запустить	что
запухнуть	пыктыны
запылиться	бусӧссьыны
запятнать	что
зарабатывать	нажӧвитчыны
зарастить	что
зардеть	гӧрдӧдны
заржаветь	сімны
заронить	что
зарябиться	гызьыны
зарядить	что
зарядить	
засвежеть	тӧвзьысьны
засветлеть	югдыны
заседать	заседайтны
заселить	
засеменить	тірӧдны
засереть	
засечь	что
засечься	керыштчыны
заскорузнуть	
заслуживать	чего
заслужить	что
засмеяться	серӧктыны
засмолить	что
заснуть	унмовсьны
засолиться	соласьны
засорить	что
заставиться	сайӧдчыны
застопорить	что
застрогать	что
застудиться	кынмыны
засучиться	пуджсьыны
засыпаться	
затаскать	что
затемнить	что
затесать	что
заткнуть	что
заткнуться	тупкысьны
затонуть	вӧйны
затопить	что
затопить	что
затравить	кого
затрепать	
затрепаться	
затуманить	что
затушевать	что
затушить	что
захворать	висьмыны
захиреть	
захомутать	
зацепиться	крукасьны
зачастить	
зачерпнуться	гумовтчыны
зачесть	что
зачинить	что
зачитать	что
зашвыривать	
зашибить	
зашить	что
заштамповать	что
защипать	
зваться	шусьыны
здороваться	видзаасьны
зевнуть	
зимовать	тӧвйыны
злоупотребить	чем
знать	
золить	что
зубрить	что
зудеть	
зудеть	
зыкнуть	
играться	
избаловаться	
избороздить	что
избочениться	
извергаться	петны
извернуться	
извести	что
известись	
изгадиться	
изгладить	что
изгладиться	
изготовить	что
изгрызть	что
издаваться	лэдзсьыны
издать	что
изжечься	сотчыны
изживаться	бырны
изжить	что
иззубриться	пиньӧссьыны
излетать	что
излить	что
изловчиться	бездоп.
изломиться	
измазаться	
измарать	что
измаслиться	выйӧссьыны
измениться	вежсьыны
измеряться	артавсьыны
измориться	жуявны
измочалиться	
измыслить	что
измять	что
изобличать	
изодрать	что
изодраться	
изрезаться	вундасьны
изрыгать	что
изрыть	что
изъездить	что
изъесть	что
иллюстрировать	что
именоваться	шусьыны
инсценировать	что
интегрировать	что
интерпретироваться	гӧгӧрвосьыны
исказить	что
исковеркаться	
искривить	что
искромсать	что
искрошить	что
испакоститься	
испилиться	ныжмыны
исписать	что
исповедовать	кого
исполнить	что
исполосовать	
испошлить	вӧкавны
испражниться	асмогасьны
испробовать	что
истаскать	что
истаскаться	
истереть	что
истолочься	чирссьыны
истопить	что
истоптать	что
истоптаться	
источать	что
источить	что
источиться	бырны
истратить	что
истрепать	что
исхитриться	
исхлестать	
исхлестаться	
исчерпать	что
исчертить	что
итожить	что
казаться	
казнить	кого
калечить	
калить	что
калькировать	что
кальцинировать	коризавны
кантовать	что
канючить	
капитулировать	инесов.
капнуть	
картёжничать	картіасьны
кассировать	инесов.
качнуть	
качнуться	
кашеварить	пусьыны
квасить	что
кидать	что
кинуть	что
кипятить	что
кислить	шоммӧдны
клацать	зяткыны
клекотать	турзыны
клюнуть	
княжить	ӧксыавны
коагулироваться	
коваться	дорсьыны
ковыряться	
кодифицировать	инесов.
кокнуть	
кокнуться	
колобродить	
колотиться	
колыхать	что
кольнуть	
кольцевать	
комкать	что
конденсировать	что
конденсироваться	
консервировать	что
консолидировать	что
консолидироваться	инесов.
конфирмовать	инесов.
концентрироваться	
копать	что
копошиться	
копулировать	инесов.
кормить	кого
короновать	юртасавны
короноваться	юртасасьны
корректировать	что
корчить	кого
корёжиться	
костылять	
кочевряжиться	
кощунствовать	смекайтчыны
краснеться	гӧрдвидзны
крепить	что
крикнуть	
кристаллизовать	что
кристаллизоваться	инесов.
кровавиться	вирӧссьыны
круглиться	гӧгрӧстчыны
кряхтеть	
кукситься	
культивировать	что
кумиться	кумасьны
купать	кого
купировать	что
куражиться	
кустарничать	
лакать	что
лакировать	что
латинизировать	латинавны
легчать	
лепить	что
лечиться	бурдӧдчыны
либеральничать	
ликовать	радлыны
лицевать	что
ломаться	
лопатить	что
лотошить	
лохматиться	
лощить	
лупить	
лягаться	чужъясьны
лягнуть	
ляпнуть	
ляпнуться	
мазать	что
мазнуть	
маклерствовать	сёрнитчӧдны
манить	кого
манкировать	инесов.
марать	
мариновать	что
маркировать	что
махать	
махнуть	
маяться	
маячить	
межеваться	юксьыны
мекать	
мелькнуть	
мельтешить	
мести	что
метать	что
мешаться	
мешкать	
миловаться	меліасьны
минерализовать	что
митинговать	митингуйтны
множиться	
модернизировать	что
молодеть	томмыны
молодиться	томмӧдчыны
молоть	что
молоться	изсьыны
монашествовать	манакавны
морозиться	кынтысьны
морщить	что
мостить	что
мочь	
мудрить	
мусолить	что
муссировать	что
мучить	кого
мчать	
мыкать	
мыться	мыссьыны
мягчить	что
мямлить	
мяукать	нявзыны
мёрзнуть	кынмыны
набраться	
набросить	что
навернуть	что
навертеть	что
навешать	что
навеять	что
наврать	
нагадить	урӧдитны
надвязать	что
надрубить	что
надсекать	сёртны
наездить	что
нажарить	что
названивать	звӧнитавны
накинуть	что
накликать	отнакли́кать
наколоть	что
накормить	кого
накрахмалить	крахмалитны
накрутить	что
накуролесить	пакӧститчыны
наладить	что
налезть	
налепить	
нализаться	
наложить	что
намазать	что
намазаться	чем
наметать	что
наметить	что
намудрить	
намусорить	ёгӧсьтны
намутить	
намылиться	быгзьыны
намякнуть	небзьыны
намять	сов
наняться	медасьны
нападать	отнапа́дать
напакостить	
написаться	гижсьыны
напитать	
наплевать	
наплевать	веськодь
напоить	кого
напороть	что
напороться	
напрячь	что
напугаться	повзьыны
напудриться	пудритчыны
напухнуть	пыктыны
напыжиться	
напыжиться	
напялить	
нарезать	отнаре́зать
нарушить	что
насекать	что
насидеть	что
наследовать	инесов.
насохнуть	косьмыны
настукать	
настыть	
насчитать	что
насыпать	отнасы́пать
насыпаться	отнасы́паться
насытиться	пӧтны
натащить	
наткнуться	
наторговать	
натрудиться	
натрястись	зӧрксьӧдны
натянуть	что
нахватать	
нахлебаться	что
нацедиться	сысъяссьыны
нацепить	что
начать	что
начертать	что
нашлёпать	
нащипать	
нащупать	что
нащёлкать	
недоглядеть	
незаметно	
незаметно	
нейтрализовать	нейтрализуйтны
непонятно	
непонятно	
нереститься	кульмыны
неясно	
неясно	
нивелировать	инесов.
низать	что
нукать	нокайтны
нянчиться	
обагриться	
обвалить	что
обвариться	сотчыны
обвисать	ӧшӧдчыны
обдаться	киськасьны
обделать	что
обезжирить	что
обезлесеть	вӧртӧммыны
обезоружить	кого
оберегаться	видзчысьны
обескрылить	кого
обеспамятеть	
обесцениться	донтӧммыны
обжариться	жаритчыны
обжать	что
обидеть	кого
обить	что
обиться	
обкатать	что
облаять	кого
облезть	
облечь	
облечь	что
обливаться	киськасьны
облизнуть	нюлыштны
облинять	
обложиться	
обмануть	кого
обмахнуться	ӧвтыштчыны
обметать	что
обмолвиться	
обморозиться	кынмавны
обмусолиться	дулльӧссьыны
обмыться	мыссьыны
обмякнуть	
обмять	что
обнадёжить	кого
обнадёжить	
обноситься	
обождать	
обозначить	что
обозреть	что
оболванить	
оболванить	
обороняться	дорйысьны
обострить	что
образовать	инесов.что
образоваться	инесов.
образумиться	
обрамлять	что
обрасти	чем
обриться	бритчыны
обронить	что
обрушить	что
обрызгаться	резсьыны
обрядить	кого
обсосать	что
обставить	
обстригаться	шырсьыны
обсчитаться	торксьыны
обтекать	что
обточить	что
обуздать	кого
обусловить	что
обучаться	велӧдчыны
обхаживать	кого
обшаркать	что
обшаркаться	
общипать	что
объяснить	что
обязать	кого
огласить	что
оглядеться	
ограбить	кого
оградить	
огрести	что
огрызнуться	
одурманить	кого
одурманиться	дикмӧдчыны
одушевить	
ожить	ловзьыны
озариться	чем
оздоровить	что
озолотить	
озонировать	что
ойкать	ойкайтны
оказать	что
окантовать	доравны
окормить	кого
окормить	
окосеть	
окрасить	что
округлить	что
окрутиться	
окрутиться	
окультурить	что
окутаться	чем
омертвить	что
омрачить	что
опалиться	чишкасьны
опаршиветь	лӧмӧссьыны
опахнуть	
опекать	кого
оперировать	
опозориться	янавны
опоить	кого
опомниться	
опоясаться	чем
опреть	нёльзьыны
оприходовать	приходуйтны
опрыщаветь	пупышӧссьыны
опухать	пыктавны
опухнуть	пыктыны
опушить	что
организовать	инесов.
организоваться	инесов.
ориентировать	инесов.
ориентироваться	инесов.
оросить	что
ороситься	кӧтасьны
орудовать	
освоить	что
освятить	что
оскалить	что
осклабить	что
ослепить	кого
ослизнуть	
основать	что
основаться	
осторожничать	видзчысьны
остричься	шырсьыны
остыть	
осудить	
осушить	что
осыпать	отосы́пать
осыпаться	отосы́паться
отбелить	что
отбиться	
отвалить	что
отвалиться	
отвариться	пусьыны
отвернуть	что
ответвиться	вожавны
отводиться	торйӧдсьыны
отвориться	воссьыны
отворотиться	
отгрузить	что
отгулять	
отделаться	
отдоиться	
откинуть	что
откинуть	
отколотить	
отколоть	что
открутить	что
откупориться	воссьыны
откушать	
отлежаться	
отлепиться	чуктыны
отложить	что
отломать	что
отломиться	чегны
отмежевать	что
отмести	что
отмочить	что
отнекиваться	пыксьыны
отняться	бырны
отогнуть	что
отозваться	
отомкнуться	воссьыны
отпаяться	чуктыны
отпеть	
отпечатать	что
отплясать	
отплёвываться	сьӧласьны
отпоить	кого
отползти	кыссьыны
отпороться	резьдыны
отпрыгнуть	чеччыштны
отпуститься	личавны
отрезать	ототре́зать
отрыгнуться	
отрясти	
отсрочить	что
отстегнуть	что
отстрадать	мучитчыссьыны
отступиться	
оттенить	что
отточить	что
отутюжить	утюжитны
отхаркнуть	карснитны
отхватить	
отчеканивать	что
отчиститься	мынны
отшибить	что
отщепить	что
отщёлкать	
оформить	что
очервиветь	лёльӧссьыны
очистить	что
ошелудиветь	лӧмӧссьыны
ощерить	
ощериться	
ощетиниться	
пакостить	
пастись	йирсьыны
пахнуть	чем
перебелить	что
перебирать	чем
перебраться	
перебраться	
перебрести	кевны
переварить	что
перевертеть	что
перевести	
перевешать	
перевить	что
переворошить	что
перевязаться	кӧртасьны
перегладить	что
перегнуть	что
перегнуться	кусыньтчыны
перегородить	что
пережарить	что
пережениться	гӧтрасявны
пережечь	что
перезвонить	
перезимовать	тӧвйыны
переиграть	что
перейти	
перекалить	что
перекинуться	
переклеить	что
перекопать	
перекормить	кого
перекрасить	что
перекраситься	
перекроить	что
перекрутить	что
перекрутить	
перекрыть	что
перекрыть	
перекувырнуться	
перекупить	что
перекусаться	пурсьыны
перелистать	что
перелить	что
переловить	кого
перелопатить	что
перемазать	
перемахнуть	
перемереть	кулавны
переметать	что
переметнуться	
перемешать	что
перемириться	бурасявны
перемогаться	
перемолотить	что
перемолоть	что
перемолоться	изсьыны
перемотать	что
перемутить	
перемяться	чукрасявны
перепасть	
перепахать	что
перепечатать	что
перепечь	что
переплавить	что
переплести	что
перепоить	кого
переполнить	что
переполоскать	что
переполоть	что
переполошиться	шызьыны
перепрятать	что
перервать	что
перерезать	отперере́зать
перерыть	что
пересдать	что
пересечь	что
пересказать	что
переспать	
переспать	
перестирать	что
перестроить	что
пересушить	что
пересыпать	что
пересыпать	смотри:пересы́пать
перетащиться	кыссьыны
перетереть	что
перетолковать	
перетопить	что
перетопить	что
перетрусить	что
переть	
перечертить	что
перешить	что
петушиться	
печататься	йӧзӧдчыны
пикнуть	
пиликать	
пихаться	
пихнуть	
пичкать	кого
плавиться	сывны
плакаться	
пламенеть	
планировать	что
плевать	
плевать	веськодь
плеваться	сьӧласьны
плодить	
плотить	
плюнуть	сьӧлыштны
плюсовать	содтыны
плюхнуть	
побегать	котралыштны
победить	
побороть	
повалить	
повенчаться	венчайтчыны
поверить	
повериться	эскыссьыны
повисеть	ӧшалыштны
повредиться	
повязаться	кӧртасьны
повёртываться	бергавны
погасать	
погасить	что
поглядеться	видзӧдчыштны
поголодать	тшыгъялыштны
погоревать	шогсьыштны
погребать	
погрести	чем
погреться	шонтысьыштны
погрешить	
погрешить	
погрустить	шогсьыштны
погрустнеть	жугыльмыштны
погуливать	
погустеть	сукмыны
подбелить	что
подбодриться	збодермыштны
подбрасывать	
подбриться	бритчыштны
подварить	
подвернуть	что
подвернуть	
подвиться	кудритчыштны
подвязать	что
подгрести	что
подевать	воштыны
подеваться	вошны
подешеветь	донтӧммыны
поджечь	что
поджить	бурдыштны
подклеить	что
подковать	кого
подковырнуть	
подмалевать	
поднести	
подогнуть	что
подорвать	что
подорожать	донсявны
подостлать	что
подпевать	кому
подпихнуть	
подправить	что
подработать	
подразделяться	юксьыны
подразумеваться	гӧгӧрвосьыны
подрасти	быдмыштны
подрезать	отподре́зать
подровнять	что
подсидеть	кого
подсиниться	лӧзӧдсьыны
подсолиться	соласьыштны
подстегнуть	кого
подстричься	шырсьыны
подстроить	что
подсушить	что
подсушиться	
подтаскивать	кыскыштавны
подтасовать	что
подтвердиться	збыльмыны
подтопить	что
подумывать	
подурачиться	
подурнеть	мисьтӧммыны
подучить	
подучиться	велӧдчыштны
подхлестнуть	кого
подчеркнуть	что
подшить	что
подыграть	кому
подышать	лолалыштны
пожать	что
пожать	что
пожелать	что
пожрать	
позабавиться	гажӧдчыштны
позабыть	
позаимствовать	что
познать	
позориться	янавны
поиграть	ворсыштны
поить	кого
поймать	кого
покапать	
покапризничать	ыдждалыштны
поколдовать	кӧлдуйтыштны
покопаться	
покормить	кого
покрапывать	тусясьны
покрикивать	
покричать	горзыштны
покруглеть	гӧгрӧсмыштны
покрупнеть	
покумиться	кумасьны
покупаться	купайтчыны
полагать	что
полениться	дышӧдчыны
полетать	лэбалыштны
полиловеть	гӧрдовлӧзӧдны
поломать	что
полоскать	что
полыхнуть	ыпнитны
польстить	кому
полёживать	куйлыны
помазаться	мавтчыштны
померкнуть	пемдыны
помечать	что
помолоть	что
помочиться	мучитчыштны
помчать	
помять	что
понадобиться	ковмыны
понатужиться	выныштчыны
понежиться	нежитчыштны
понукать	кого
пообедать	нуръясьыштны
пообещаться	кӧсйысьны
попастись	йирсьыштны
попеть	сьылыштны
попискивать	дзизӧдчыны
поплясать	йӧктыштны
попрятаться	дзебсявны
порассуждать	тӧлкуйтыштны
порешить	
пороться	резьдыны
портняжить	вурсьыны
порушить	что
порыхлеть	небзьыны
порябеть	серӧссьыны
посапывать	нускыны
посвистать	
посвистеть	шутьлялыштны
посечь	
посеять	что
послышаться	кывны
посовеститься	яндысьыштны
посохнуть	косьмавны
поспать	узьыштны
поспешить	тэрмасьны
постричься	шырсьыны
посудачить	суклясьыштны
посуроветь	кӧдздӧдны
посушиться	косьтысьыштны
посыпать	
посыпать	отпосы́пать
потереть	что
потонуть	
поужинать	ужнайтны
поучиться	велӧдчыштны
похаживать	
похварывать	висьыштавны
похлебать	
похлестаться	швачӧдчыштны
похрипеть	киргыштны
почать	
почерстветь	чорзьыны
почитать	что
почить	
пошаливать	
пошевеливаться	
пошелестеть	кышӧдчыштны
пошелохнуться	вӧрзьыштны
пошипеть	дзужмунны
поёжиться	йӧжгыльтчыны
править	что
практиковаться	практикуйтчыны
пребывать	
превозвыситься	
превысить	что
предложить	кому
предъявить	что
презентовать	инесов.
преломить	что
преобразиться	вежсьыны
преобразовать	что
пресечь	что
претерпеть	что
прибедняться	
прибить	что
прибиться	
прибрать	
прибраться	
привадить	кого
привернуть	
привинтиться	винтитчыны
привить	что
привлекаться	кыскыссьыны
приворожить	кого
привстать	кыпӧдчыштлыны
пригладить	что
пригласить	кого
приглушить	что
пригреться	шонтысьыштны
приземлить	что
приключиться	лоны
прикусить	что
прилепить	что
прилепиться	
прильнуть	
прильнуть	
приманить	кого
примелькаться	
принюхиваться	исасьны
приобщить	
приостановиться	
припахивать	
припаять	что
припевать	сьывны
приплестись	кыссьыны
приплясывать	йӧктыштавны
припоздниться	сёрмыны
припудриться	пудритчыштны
прирезать	кого
присвистнуть	шутёвтны
прискучить	кому
присовокупить	что
присыпать	отприсы́пать
притемнить	пемдӧдыштны
приткнуть	что
приткнуться	
приткнуться	
притоптаться	таляссьыны
притупить	что
притухнуть	лаймавны
притушить	что
приударить	
прицепить	что
причаститься	даръясьны
пришепётывать	пыскылясьыштны
пробарабанить	барабанитны
пробить	что
проболтать	
пробудиться	
проварить	что
проведать	
провернуть	что
провозиться	
проволочить	
провоцировать	инесов.
прогнить	сісьмыны
проголодать	тшыгъялыштны
проделать	что
продиктовать	что
продраться	
продублировать	дублируйтны
продёрнуть	
прожарить	что
прожечь	что
прозимовать	тӧвйыны
произнести	что
прокатать	что
прокопать	что
прокрасить	что
прокрахмалиться	кракмалитсьыны
прокуковать	кокыштны
прокутить	
проложить	что
пролопотать	ватлалыштны
промариноваться	маринуйтчыны
промаршировать	маршируйтны
промекать	баксыны
промесить	что
проморить	кого
промыть	что
промяться	
промяукать	нявӧстны
пронести	
пропарить	что
пропахать	что
пропеть	что
пропечь	что
прописаться	гижӧдчыны
проплясать	
прополоть	что
пропылиться	бусӧссьыны
прорезать	что
проржаветь	сімны
прорисовать	что
прорубить	что
прорыть	что
просеять	что
проскользнуть	
просмолить	что
просмолиться	сирассьыны
прососать	что
проспрягать	вежлавны
проституировать	
простыть	
просунуться	
просушить	что
просыпать	отпросы́пать
просыпаться	отпросы́паться
протащиться	кыссьыны
протаять	сывны
протереть	что
протопить	что
протоптать	что
проточить	что
протрезвиться	палявны
протянуть	что
протянуться	
проурчать	гуркнитны
профилировать	что
прохлаждаться	
прохрипеть	киргыштны
процедить	что
прочесать	что
прочитать	что
прошагать	кырссьыштны
прошаркать	чушмунны
прошнуровать	что
проштамповать	что
прощай(те)	
проявить	что
пудриться	пудритчыны
пузыриться	
пукать	сурттывны
пучить	
пучиться	
пыжиться	
пылиться	бусӧссьыны
пытать	кого
пыхать	чем
пялить	что
работать	уджавны
разбаловаться	
разбогатеть	озырмыны
разболтать	
разболтаться	
разбраниться	
разбрасываться	
разбредаться	разӧдчавны
разбрызгать	что
разбрызгаться	резсьыны
развалить	что
развалять	что
развезти	
развертеть	что
развеселиться	гажмыны
развесить	что
развеситься	ӧшӧдчыны
развеять	что
развлечь	кого
разворотить	что
разворошить	что
развратить	кого
развратничать	кырсасьны
разгадать	что
разглагольствовать	лавгыны
разгладить	что
разговорить	кого
разговориться	
разгуляться	
разделать	что
разделаться	
раздразнить	
раздробить	что
раздувать	что
раздуть	что
разжевать	что
разжечь	что
разжиться	
раззеваться	
раззудеться	
разладить	что
разладиться	
разлакомить	кого
разлакомиться	ыштыны
разлезться	
разлениться	дышмыны
разложить	что
разломать	что
размазать	что
размазаться	паськавны
размежевать	что
размельчиться	поснявны
размерить	что
размеситься	лойсьыны
разминуться	
разморозиться	сывны
размотаться	разьсьыны
размочалиться	бонзьыны
размыть	что
разнежить	кого
разнежиться	
разнуздать	кого
разняться	
разогнуть	что
разодеться	вӧччыны
разодраться	
разомкнуть	что
разостлать	что
разработать	что
разрегулироваться	дзугсьыны
разредить	что
разрезать	что
разрезать	отразре́зать
разрешить	что
разрисовать	что
разродиться	
разрознить	что
разрушить	что
разрыть	что
разрыхлеть	небзьыны
разрыхлиться	небзьыны
разрядить	что
разъездить	
районировать	что
раскатать	что
раскатить	что
раскинуть	что
расклеить	что
расклепать	что
расклинить	что
расколотить	что
раскосить	что
раскроить	что
раскрутить	что
раскрыть	что
раскудахтаться	
раскупориться	воссьыны
раскуриться	ӧзйыны
распалить	
распалиться	
распатронить	
распахнуть	что
распереть	что
распечатать	что
распечататься	воссьыны
распивать	что
распилиться	орны
распихать	
расплавиться	сывны
расплеснуть	солькнитны
расплестись	разьсьыны
распороть	что
распороться	резьдыны
расправить	что
распростереть	
распростереться	
распространить	что
распылить	что
распялить	что
рассечь	что
расследовать	что
рассмеяться	серӧктыны
рассорить	что
рассыпать	отрассы́пать
рассыпаться	отрассы́паться
растаскать	что
растащить	
растворить	что
растеребить	
растереть	что
растормошить	
расточать	
растратить	что
растревожить	
растрепать	что
растрогаться	нормыны
раструсить	что
растыкать	что
растянуть	что
расхлебать	что
расхлябать	
расхлябаться	
расходиться	
расчесаться	
расшатать	что
расшевелиться	
расшириться	паськавны
расшить	что
расшиться	резьдыны
расшифровать	что
расшуметься	
расщепить	что
рвануть	
рвать	что
рдеть	
реализовать	что
реализоваться	инесов.
революционизировать	инесов.
революционизироваться	инесов.
регулировать	что
редактировать	что
реконструировать	что
реять	
ржаветь	сімны
ритмизировать	ӧдъявны
ровнять	что
роговеть	чорзьыны
родить	инесов.
родиться	инесов.
русифицировать	рочмӧдны
русифицироваться	рочмыны
рыгать	горзявны
рыгнуть	горзьыны
рыть	что
рядить	
рядиться	
садовничать	
салиться	госӧссьыны
сандалить	что
сбрендить	
свалять	что
сварить	что
сватать	кого
свататься	корасьны
свеситься	ӧшӧдчыны
свинтить	что
свистнуть	
свить	что
свихнуться	
сводничать	гозйӧдны
сволочь	
сгинуть	
сгладить	что
сговорить	кого
сгонять	
сготовить	что
сгустить	что
сдвоиться	кыкпӧвстасьны
сдирать	что
секретничать	
сентиментальничать	
серебрить	что
сеять	что
сигнализировать	инесов.
синить	что
синтезировать	что
систематизировать	что
скандалить	
скатать	что
скать	что
сквитать	что
скидать	что
скоблить	что
скользнуть	
скомкать	что
сконструировать	что
скопировать	что
скорчить	кого
скорёжиться	
скосить	что
скосить	что
скрасить	что
скрепить	что
скривиться	
скрутиться	гартчыны
скудеть	
скучнеть	гажтӧммыны
слабнуть	
слазить	
слепнуть	синтӧммыны
слечь	
слизать	что
слинять	
слить	что
сложить	что
сломать	что
слупить	
слыхать	
слышно	
слышно	кывны
слышно	
слышно	кывсьыны
слышно	
смаковать	что
смелеть	збоймыны
смести	что
сминать	что
смолить	что
смолить	
смолкнуть	ланьтны
сморкаться	сульсьыны
сморщить	что
смотать	что
смыть	что
смягчить	что
снежить	
сновать	что
сносить	
соблазнить	кого
соблюдать	что
совершить	что
совместить	что
совратить	кого
содрать	что
сознавать	что
созорничать	вильшасьны
сойти	
солодеть	юммыны
солодить	что
сомкнуть	что
соорудить	что
сопровождаться	чем
сосать	что
соснуть	узьыштны
составить	что
составиться	
состариться	пӧрысьмыны
состряпать	что
состыковать	что
состыковать	
сочить	что
спалить	что
спасовать	
спиться	юсьыны
сплести	что
сплыть	
споить	
справить	что
спроситься	
спрыгнуть	чеччыштны
спрыснуть	что
сразить	кого
срастить	что
срезать	что
срезаться	провалитчыны
срубить	что
ссыпать	что
стажировать	стажируйтчыны
створожиться	рысьмыны
стереть	что
стерилизовать	инесов.
стечь	визувтны
стимулировать	
стиснуться	топавны
столпиться	чукӧртчыны
стопорить	что
стопориться	
стоптать	что
сторговаться	донъясьны
стравить	что
страховаться	страхуйтчыны
стричься	шырсьыны
строгать	что
стронуться	вӧрзьыны
струиться	
струсить	повзьыны
стряпать	что
стрясти	что
стыковать	инесов.
сулить	
суметь	
суммировать	
суслить	что
схлестнуться	
схлопотать	что
сцепить	что
сшить	что
сытеть	пӧтны
таксировать	что
таранить	что
тарахтеть	
тарахтеть	
таращиться	
таскать	
тащить	
тащиться	
творить	что
творить	что
творожиться	рысьмыны
тереть	что
терпеться	
терроризировать	кого
тесать	что
тлеться	
токарничать	токаравны
толкнуть	что
толочься	
тонировать	что
топить	что
топорщить	что
топорщиться	
топтать	
топтаться	
торгашествовать	
торговаться	
тормозить	что
торосить	тӧрӧгавны
тороситься	тӧрӧгассьыны
торпедировать	что
торцевать	что
тошнить	кого
травить	что
травмироваться	доймыны
трактовать	
тралить	что
трахнуть	
трахнуться	
требоваться	ковны
трезвить	пальӧдны
тренироваться	тренируйтчыны
тренькать	
трепыхаться	
трескать	что
трусить	
тужиться	
туманить	что
турлыкать	тюрликайтны
тушевать	что
тушить	что
тушиться	пражитчыны
тягать	
тяпнуть	
убавиться	чинны
убедить	кого
убиваться	
убиться	
уважить	
увалять	что
уварить	что
увариться	
увеличить	что
увечиться	доймыны
увещать	кого
увильнуть	
уволить	кого
увязать	что
угасить	что
углубить	что
углядеть	
угнездиться	
уговорить	кого
угрохать	что
угрызаться	мучитчыны
уделать	
удешевиться	донтӧммыны
удорожиться	донсявны
удостоиться	
удручить	кого
удушиться	
уездить	
уездиться	
ужариться	
ужаться	
ужинать	ужнайтны
узреть	что
указываться	индыссьыны
укалываться	бытшласьны
укачать	кого
укипеть	
укоренить	что
укрепить	что
уладить	что
улежать	куйлыны
уловить	что
умалить	что
умаслить	кого
умедлиться	надзмыны
умельчиться	посняммыны
уменьшить	что
умериться	чинны
умничать	
умножить	что
умножиться	содны
уморить	кого
умостить	что
умудриться	
умыкнуть	кого
умыться	мыссьыны
умять	что
умяться	
унавозить	куйӧдавны
унаследовать	что
унюхать	что
унять	
уняться	
упереть	
упечься	пӧжассьыны
уписать	что
упиться	чем
уплести	что
упоить	кого
управиться	
упраздниться	бырны
упредить	кого
упростить	что
упрочить	что
упрятать	
упрятаться	дзебсьыны
уравновесить	что
урваться	
урезать	что
урезать	отуре́зать
уронить	что
урчать	
усвоить	что
усечь	что
усеять	что
усилить	что
ускорить	что
услышать	что
усовершенствоваться	бурмыны
усолиться	солассьыны
установить	что
устлать	что
устлаться	вевттьысьны
устремить	что
усыпать	что
усыпать	отусы́пать
утаить	что
утаиться	
утеплиться	
утеряться	вошны
утешить	кого
утихомирить	
утихомириться	
уткнуться	
утолить	что
утопать	
утрамбовать	что
утрудить	
утрудниться	сьӧктаммыны
утыкать	что
утыкать	отуты́кать
утюжить	что
утюжиться	утюжитчыны
утяжелиться	сьӧктаммыны
утянуть	
ухватить	
ухватиться	
ухлопать	
уходить	кого
уходиться	
учетвериться	нёльпӧвстасьны
учредить	что
учуять	что
ушестериться	квайтпӧвстасьны
ушибиться	доймыны
ушириться	паськавны
ушить	что
ущемиться	топавны
ущипывать	что
фабриковать	что
фальсифицировать	что
фальцевать	что
фиглярить	
фигурять	
фиксировать	что
фильтровать	что
финтить	
фокусничать	
формовать	что
форсировать	что
фотографироваться	снимайтчыны
франтить	тшапитчыны
фрезеровать	инесов.
фуговать	что
функционировать	уджавны
фыркнуть	
халтурить	
хапать	
хапнуть	
характеризоваться	торъявны
харкать	сьӧласьны
хвастать	
хватить	
хватить	
хватиться	
хлебать	что
хлебнуть	
хлестнуть	
хлопнуть	
хлопнуться	
хлорировать	
хлюпать	
хмелить	кого
хныкать	
хороводить	
хороводиться	
хоронить	
хотеться	
хранить	что
храниться	видзны
хрустнуть	
хрястнуть	
хрястнуться	
цапаться	
цапнуть	
цедить	что
целоваться	окасьны
цементировать	инесов.
центровать	
центровать	
цеплять	
церемониться	
циркулировать	
цыганить	
чалиться	домасьны
чеканить	что
черкать	что
черпать	что
чертить	что
чикнуть	что
чинить	что
чихвостить	кого
чихнуть	
чмокать	
чмокнуть	
чувствовать	что
чувствоваться	кывны
чуяться	
шаблонизироваться	ӧтногасьны
шарахнуть	
шарахнуться	
шаржировать	
шарить	
шаркнуть	
шваркнуть	
шваркнуться	
швырять	
швыряться	
шибануть	
шибать	
шикарничать	тшапитчыны
шикать	
шинкарить	
ширить	что
шить	что
шлифовать	что
шлюзовать	что
шмыгать	
шнуровать	что
шнырять	
шпынять	кого
штамповать	что
штормовать	
штормовать	
штукарить	шундыртны
шуровать	
шушукаться	
щелкнуть	
щепаться	юкасьны
щерить	что
щериться	
щипать	
экономиться	чӧжсьыны
экстрагировать	что
электризовать	инесов.
юлить	
юнеть	томмыны
юродствовать	
