abstrákta	abstrakti
addes	antelias
addi	antelias
addálas	antelias
adni	käytteliäs
ahkahaš	ikäinen
ahkit	ikävä
ahkit	tylsä
ahkásaš	ikäinen
aiddolaš	täsmällinen
akademalaš	akateeminen
aktiiva	aktiivinen
akustihkalaš	akustinen
albma	oikea
albma	aito
albma	kunnon
alfabehtalaš	aakkosellinen
alit	sininen
alladávttat	romuluinen
alladávttálaš	romuluinen
allamielalaš	ylimielinen
allat	korkea
allosaš	korkuinen
almmolaš	julkinen
almmáilaš	miehekäs
almmálaš	taivaallinen
alvvalaš	tarmokas
amas	vieras
anistuhkes	himokas
antihkalaš	antiikkinen
apostovllalaš	apostolinen
arat	kiihkeä
arktalaš	arktinen
arveš	tarmokas
arvves	sateinen
arvái	sateinen
asehaš	ohut
aseheapme	ohut
assosaš	paksuinen
assái	paksu
asttuheapme	kiireinen
asálaš	paksuketinen
automáhtalaš	automaattinen
badjeliiluohtehahtti	luotettava
bahá	paha
bahá	vihainen
bahča	kitkerä
bahča	katkera
bahča	pahanmakuinen
bahča	karvas
bajimus	ylin
bajimus	ylimmäinen
bajimuš	ylin
bajit	ylempi
ballalas	pelokas
ballevaš	pelkääväinen
baluheapme	peloton
balvái	pilvinen
barbáralaš	barbaarinen
barggeš	työteliäs
barggoš	työteliäs
baski	ahdas
bassi	pyhä
bastil	terävä
basttoheapme	tylsä
bažekeahttá	lypsämätön
bažihahtti	lypsettävä
beaivválaš	jokapäiväinen
beaivválaš	päivittäinen
beakkán	kuuluisa
beaktil	tehokas
beaktil	ravitseva
bealjeheapme	kuuro
bealljái	isokorvainen
bealátkeahtes	puolueeton
beanttis	suora
beasseheapme	tuoheton
beasseheapme	vähätuohinen
beavkálas	hölösuinen
beaški	paukkuva
belgialaš	belgialainen
berošteaddji	kiinnostunut
bibmui	ruokaisa
biekkus	tuulinen
bienalaš	yksityiskohtainen
bierffas	pörröinen
biikái	piikikäs
bilaterála	bilateraali
bilaterála	kahdenkeskinen
biologalaš	biologinen
birgui	lihakas
birolaš	pirullinen
bissovaš	pysyvä
bistevaš	pysyvä
bistil	pitkäaikainen
bistil	pitkäikäinen
bisttiheapme	lyhytaikainen
bisttiheapme	riittämätön
bivaheapme	viluinen
bivastuhkes	hikoileva
bivnnuheapme	epäsuosittu
bivnnut	suosittu
bivval	leuto
bivval	lauha
bivššas	tyylikäs
boaddit	kookas
boahtte	seuraava
boahtte	tuleva
boahtte	ensi
boahttevaš	tuleva
boaldevaš	polttava
boaresáigásaš	vanhanaikainen
boaris	vanha
boarka	äkkipikainen
boasttu	väärä
bolffas	tuuhea
borggas	pyryinen
borgái	pyryinen
borgárlaš	porvarillinen
borrái	särmikäs
boršui	kuohuva
bođđui	karikkoinen
brihttalaš	brittiläinen
buhtis	puhdas
buljas	pullottava
bullas	pullottava
bulljái	pullottava
bullái	pullottava
buoiddeheapme	rasvaton
buoiddeheapme	vähärasvainen
buoidi	lihava
buoidi	paksu
buolaš	pakkanen
buollevaš	palava
buolli	palava
buoloheapme	palamaton
buorggos	kielletty
buorre	hyvä
buotveagalaš	kaikkivaltias
buozas	sairas
buozus	sairas
buozus	sairaana
buskolas	piereskeleväinen
bussái	verkkainen
buškkas	soukka
báddebahá	änkyrä
báhcálas	vitkutteleva
báhkas	kuuma
báikkolaš	paikoittainen
báikkolaš	laikukas
báikkálaš	paikallinen
báitevaš	loistava
báitevaš	loistelias
báitil	loistava
bákkolaš	pakollinen
bálgáheapme	poluton
bállir	kiikkerä
bállir	ympäripyöreä
bállálas	ammuva
báltalaš	balttilainen
bánžžas	pöhöttynyt
báraheapme	pariton
báralaš	parillinen
bárrahaš	paraskin
bávččas	kipeä
bávččas	kivulias
bávččaskeahtes	kivuton
bážekeahttá	ampumaton
caggasan	estoinen
cahkkat	räikeä
ceakkus	jyrkkä
civzza	karvas
coagis	matala
coazzi	kitsas
dadnái	tinakas
dagolaš	velallinen
dalloš	silloinen
dalá	silloinen
davrras	kurttuinen
davviriikkalaš	pohjoismainen
deahkkái	lihaksikas
deaivil	osuva
deaivil	naseva
dearvvas	terve
dearvvas	terveellinen
dearvvaš	terve
dearvvaš	terveellinen
dearvvašmeahttun	epäterveellinen
deasttaheapme	häikäilemätön
deatalaš	tärkeä
deavdemeahttun	täyttymätön
deavkat	himmeä
deaŧalaš	tärkeä
dehálaš	tärkeä
deivvolaš	satunnainen
dekčolas	rusenteleva
demokráhtalaš	demokraattinen
devkesruškes	tummanruskea
diehtemeahttun	tietämätön
dielvvis	tasainen
dievas	täysi
dievaslaš	täydellinen
dievasmeahttun	epätäydellinen
dieđalaš	tieteellinen
dieđus	tiettävä
diggojahkes	käräjöivä
digitála	digitaalinen
dihkkái	täinen
dihto	tietty
dihtomielalaš	tietoinen
dihttes	tietäväinen
dilddas	hyllyvä
dilálaš	kiireetön
dimis	pehmeä
dirbbot	hätäilevä
divas	saita
divrras	kallis
diđolaš	tietäväinen
diđolaš	tietoinen
diđolaš	tunnettu
doaibmi	aktiivinen
doaimmaheapme	toimeton
doaimmaheapme	aloitekyvytön
doaimmalaš	toimelias
doaivvuheapme	toivoton
doaladahkes	pidättelevä
doavki	tyhmä
doavkkas	tyhmähkö
dobbelaš	sikäläinen
dohkálaš	kelvollinen
dohkálaš	pätevä
dohkálaš	sopiva
doksái	sammaltava
dolaheapme	lämmittämätön
dolaheapme	tuleton
dolalaš	salamannopea
dolddas	kulunut
dološ	muinainen
dološ	vanha
dolá	entinen
dorrolas	tappelunhaluinen
dorrolas	puskuri
dorvvolaš	turvallinen
dorvvuheapme	turvaton
dorvvuheapme	masentunut
dovdameahttun	tuntematon
dovddolaš	tunnollinen
dovddus	tunnettu
dovddus	tuttu
duggolas	takkuuntuva
duhkorahkes	leikkisä
duhkordallalas	leikkisä
duhtavaš	tyytyväinen
duiska	saksalainen
dulppas	tylppä
dulpái	tylppä
dumpái	sammaltava
dumsui	vanuttuva
duoddul	sietokykyinen
duoddul	uskalias
duoggái	takkuinen
duohta	totta
duohta	tosi
duokkas	takkuuntuva
duokkas	rujo
duolbbas	litteä
duoldalas	puhelias
duolvalas	liantunteva
duolvil	liantunteva
duolvvas	likainen
duorššas	litteänaamainen
duorššas	lättänaamainen
duostil	uskalias
duođalaš	vakava
durjjas	sottainen
duskkas	ärtyisä
duskái	tuskainen
duskái	ärtyisä
duđaheapme	tyytymätön
duđavaš	tyytyväinen
duđđalas	kuhnaileva
duđđalas	hössöttävä
dábiheapme	änkyrä
dábálaš	tavallinen
dádjolas	houkkaava
dáiddalaš	taiteellinen
dáidduheapme	taitamaton
dálkkaslaš	lääkkeellinen
dálsái	jaaritteleva
dálvvas	talvinen
dálá	nykyinen
dálá	tämänhetkinen
dáláš	nykyaikainen
dámakeahtes	kesyttämätön
dánmárkulaš	tanskalainen
dánska	tanskalainen
dánskalaš	tanskalainen
dánáigge	nykyään
dánáigge	nykyaikana
dárbbašlaš	tarpeellinen
dárbbašmeahttun	tarpeeton
dárbbuheapme	tarpeeton
dárki	tarkka
dárkil	tarkka
dárkilmeahttun	epätarkka
dárogielat	norjankielinen
dárrolaš	norjalainen
dárrolaš	norjantaitoinen
dáseheapme	epäsäännöllinen
dássásaš	tasavertainen
dássáš	tähänastinen
dávdái	tautinen
dáđas	tahmainen
dáškái	ryvettävä
eahccil	mieltynyt
eahccil	seurallinen
eahpegulolaš	tottelematon
eahpesihkar	epävarma
eahpeveaddji	huonovointinen
eahpečielggas	epäselvä
eahpidahtti	epäilyttävä
eaktodáhtolaš	vapaaehtoinen
ealas	elinvoimainen
ealas	elollinen
ealjoheapme	toimeton
eallilan	iäkäs
ealus	eloansa
eambbo	enemmän
earenoamáš	erinomainen
earálágan	erilainen
eatnanlaš	maallinen
eatneheapme	äiditön
eatnálaš	äidillinen
eavas	itkunherkkä
eaŋkal	killinki
eaŋkal	yksinkertainen
ekologalaš	ekolooginen
ekonomalaš	taloudellinen
ekonomálaš	taloudellinen
endena	kunnon
erdui	ärtyisä
erenoamáš	erikoinen
erenoamášpedagogalaš	erikoispedagoginen
erenomáš	erityinen
eurohpalaš	eurooppalainen
evttolaš	ehdollinen
evttolaš	tahallinen
falli	nopea
faskár	varasteleva
fasti	iljettävä
fasti	huono
faŋkkas	kurokaulainen
fiinnis	hieno
fioleahtta	violetti
fiskat	keltainen
fiskeslágan	keltahko
formála	muodollinen
formálalaš	muodollinen
friddja	vapaa
friddja	vapaasti
friija	vapaa
fuolaheapme	välinpitämätön
fuolalaš	huolellinen
fuolkái	sukurakas
fuollameahttun	huolimaton
fuotni	huono
fágalaš	ammatillinen
fámolaš	voimakas
fásta	vakio
galdái	paksurunkoinen
gallji	väljä
gallás	kylläinen
gallás	täynnä
galmmas	kylmä
gappas	valkoinen
garas	kova
garppas	hillitön
gaskaboddasaš	väliaikainen
gaskaboddosaš	väliaikainen
gaskamearálaš	keskivertainen
gaskariikkalaš	kansainvälinen
gaskkamus	keskimmäinen
gassat	paksu
geabbil	ketterä
geaffi	köyhä
geafi	köyhä
geahnoheapme	heikko
geahpas	kevyt
gearggus	selkeä
gearpmus	hämärä
gearrat	kiiltävä
geaseheapme	pieni
geasoheapme	pieni
geassásaš	yksikesäinen
geatkkas	matalajalkainen
geavatlaš	käytännöllinen
geavllas	kaareva
geađgái	kivinen
gelbbolaš	kelvollinen
gelddolaš	jännittävä
geográfalaš	maantieteellinen
gerges	joutuisa
gerolmas	kuuluisa
gielaheapme	ansaton
gielalaš	kielellinen
gierdavaš	kärsivällinen
gierdil	kärsivällinen
gierremas	ohutseinäinen
gievra	vahva
gievra	voimakas
girdálas	lentelevä
girjjat	kirjava
girjái	kirjava
girkolaš	kirkollinen
givas	päättäväinen
givas	peloton
givrras	köyry
goaidi	lohenpunainen
goalmmát	kolmas
goalššas	kolea
goavis	ankara
goavis	kovasydäminen
goavrras	köyry
goađut	tyly
gohpolas	tahmea
gohppái	kuoppainen
gohppái	painanteinen
gohppái	syvänteinen
gohččui	nokinen
goikkis	kuiva
golgi	virtaava
golgi	juokseva
gollas	kultainen
gollolas	palelevainen
gollái	kultainen
golnnas	kuihtunut
gonagaslaš	kuninkaallinen
govdat	leveä
govdu	kelluva
govttolaš	kohtalainen
govttolaš	kohtuullinen
guhkesjuolggat	pitkäjalkainen
guhkki	pitkä
guhkkosaš	pituinen
gulccas	huono
gulles	tarkkakorvainen
gulles	herkkäuninen
gullevaš	kuuluva
guohca	mätä
guohca	pilaantunut
guoleheapme	kalaton
guolgái	karvainen
guorus	tyhjä
guoskevaš	koskien
guovddáš	keskeinen
guovllulaš	alueellinen
guovlulaš	alueellinen
guovnnjas	ontto
guovttegielalaš	kaksikielinen
guovttegielat	kaksikielinen
guppas	kyssäniskainen
gurut	vasen
gustojeaddji	kelvollinen
gustovaš	koskevan
guvhllas	kuhmuinen
guđat	kuudes
guđát	kuudes
gušmmus	jäykkä
gušmmus	karski
gáfat	kauhea
gáirras	juovainen
gálššas	kolea
gánas	viluinen
gánnáhahtti	kannattava
gárkka	kitkerä
gárvvis	valmis
gárži	kapea
gárži	ahdas
gásttas	märkä
gáttimus	rannimmainen
gávccát	kahdeksas
gávkkas	toljottava
gávkkas	kolkko
gávppálaš	kaupallinen
gávvil	ovela
gávvil	katala
harbmat	hirmuinen
heaboheapme	hävytön
headju	heikko
headju	huono
heahpatlaš	häpeällinen
heahtahaš	hädänalainen
heakkalaš	elollinen
heakkalaš	henkinen
hearccas	lähentelevä
hearcái	lähentelevä
hearki	herkkä
hearrái	herraskainen
hearvái	huvittava
hearvás	ihana
hearvás	kirkastaa
hebreálaš	heprealainen
hegges	sitkeähenkinen
heggeš	sitkeähenkinen
heila	koko
heittot	heikko
heittot	huono
heivemeahttun	sopimaton
heivemeahttun	soveltumaton
heivvolaš	sopiva
herskui	nirso
hilbat	villi
hillján	hiljainen
himolaš	himokas
himuheapme	himoton
hiras	vauhko
hirbmat	hirveä
historjjálaš	historiallinen
hiđis	hidas
hiŋkálas	nyyhkyttäväinen
hohpolaš	kiireellinen
hubmái	puhelias
hurskkis	hurskas
hutkkálaš	kekseliäs
hutkái	kekseliäs
háddjái	haiseva
háissas	haiseva
hálaheapme	puhumaton
hálaheapme	vähäpuheinen
hálbi	halpa
hálddahuslaš	hallinnollinen
hállái	puhelias
hárbmalas	äreä
hárdui	leveäharteinen
hárpmas	ärtyisä
hárvi	harva
hárvvis	harva
háskár	haaskaava
hávski	hauska
ievttá	eilinen
iešguđetlágan	monenlainen
iešguđetlágan	erilainen
iešheanalaš	itsenäinen
ihcaveaiddat	itsepintainen
ihcaveaiddat	omavaltainen
ihcaválddat	itsepintainen
ihcaválddat	omavaltainen
ihttá	huominen
imaš	kummallinen
imaš	ihmeellinen
imašlaš	ihmeellinen
individuála	yksilöllinen
ipmilhis	jumalattoman
ipmirdahtti	ymmärrettävä
issoras	hirveä
issoras	kamala
ittis	pulska
ivdnái	värikäs
ivnneheapme	väritön
ivnneheapme	kalvakka
iđidaš	aamuinen
jabbolas	mulkoileva
jahkásaš	yksivuotinen
jalahas	pilvetön
jalla	hullu
jalla	typerä
jarffas	pullea
jarfái	pullea
jaskat	hiljainen
jaskat	tyyni
jaŋas	rutikuiva
jeagatmeahttun	tottelematon
jeaggái	soinen
jeagiheapme	vuotava
jeagoheapme	tottelematon
jearggalaš	järkevä
jearggalaš	johdonmukainen
jeđđehahtti	lohdutettava
jeđđehahtti	lohtuisa
jidnii	äänekäs
jiegŋái	jäinen
jiehkkái	jäätikköinen
jierbmái	järkevä
jierbmái	järjellinen
jierpmeheapme	järjetön
jierpmálaš	järjellinen
joavdelas	joutava
joavdelas	joutilas
joavdil	joutuisa
johtil	nopea
jolggalaš	julkinen
joraheapme	pyörimätön
jorbat	pyöreä
jorbbas	pyöreä
jorbmái	syvänteinen
jorgalmeahttun	kääntymätön
jođiheapme	luistamaton
jođuheapme	luistamaton
jođán	nopea
jođán	nopsa
judnii	juonikas
jugahahtti	juotava
juggái	painanteinen
juguheapme	raitis
julev	luulaja
julggaheapme	salakähmäinen
jullái	meluisa
julmmut	tyly
juohkelágan	kaikenlaiset
juoigalas	joikaavainen
juolggeheapme	huonojalkainen
juolggálaš	nopsajalkainen
juorbbas	kiikkerä
juorbbehas	kiikkerä
jurbolas	kiikkerä
juridihkalaš	juridinen
juvdálaš	juutalainen
jábálaš	vauras
jáffui	jauhoinen
jáhkehahtti	luultavasti
jáhkkemeahttun	epäuskoinen
jáhkkemeahttun	uskomaton
jáhkkeš	herkkäuskoinen
jáhkkil	hyväuskoinen
jáhkkálas	herkkäuskoinen
jállu	rohkea
jállu	peloton
jámolaš	kuolevainen
jánas	kutistunut
jápmemeahttun	kuolematon
jápmán	kuollut
jávrreheapme	järvetön
jávrreheapme	vähäjärvinen
keaisárlaš	keisarillinen
klovkken	ovela
knáhpis	niukka
knáhpis	visu
konkrehta	konkreettinen
konkrehtalaš	konkreettinen
kristtalaš	kristillinen
kránto	kranttu
kultuvrralaš	kulttuurinen
kuonna	virtsanhajuinen
lagamus	lähin
lagamuš	lähin
lagamuš	lähimmäinen
lagas	läheinen
lagaš	läheinen
lastái	lehtevä
leahkkái	laaksoinen
lestadiánalaš	lestadiolainen
liekkas	lämmin
liekkus	mieto
lihkoheapme	onneton
lihkolaš	onnellinen
lihkuheapme	onneton
liiggálaš	erikoinen
liiggálaš	liiallinen
linccas	repaleinen
linis	pehmeä
loahpalaš	lopullinen
loarffas	löntystävä
loarffas	pörröinen
lobiheapme	laiton
lobálaš	luvallinen
lobálaš	laillinen
logádat	kymmenys
logát	kymmenes
lohkameahttun	lukematon
lossat	raskas
lossat	painava
luhteránalaš	luterilainen
luktui	oikukas
lulimus	eteläisin
lulimus	itäisin
lulit	eteläisempi
lulit	itäisempi
lunddolaš	luonnollinen
luohkkái	mäkinen
luohtehahtti	luotettava
luohttevaš	luotettava
luovaskas	helppolypsyinen
luovus	irtonainen
luvas	liotettu
lágalaš	laillinen
lágan	sellainen
láhkásaš	kaltainen
láiki	laiska
láittas	tylsä
láitálas	moittivainen
láivi	heikko
lávkái	pitkäpistoinen
láđis	lempeä
lášmat	vikkelä
mannan	viime
maŋimus	viimeinen
maŋimuš	viimeinen
meaddugas	erehtyväinen
mearkkašahtti	merkityksellinen
mearrideaddji	määräävä
meađggus	imelä
meađggus	raskas
mielkkas	runsasmaitoinen
mielkái	runsasmaitoinen
miellagiddevaš	mielenkiintoinen
miellasaš	mieluinen
mieseheapme	vasaton
mievkkis	pehmeä
mirkkolaš	myrkyllinen
moiddas	pahoinvoiva
molddas	murentunut
mollui	mureneva
molssaevttolaš	vapaaehtoinen
morašlaš	surullinen
morris	aamuvirkku
morrái	aamunvirkku
mosttas	samea
muhttui	isonaamainen
muldui	multava
muolddas	multainen
muoldái	multava
muoraheapme	puuton
muoraheapme	vähäpuinen
muoraheapme	ohut
muorjái	marjava
muoseheapme	rauhaton
muttolaš	kohtuullinen
muttát	sopiva
máhken	vertainen
máihlái	mahlainen
máilmmálaš	maailmallinen
máizzas	sula
máizzas	leuto
mánáheapme	lapseton
mávssolaš	arvokas
máŋggabealat	monipuolinen
máŋggakultuvrralaš	monikulttuurinen
máŋggalágan	monenlainen
mášoheapme	levoton
máššil	malttavainen
máŧolaš	mahdollinen
nagirheapme	uneton
nalas	lököttävä
nalttas	pätkä
namaheapme	nimetön
nammasaš	niminen
nanus	luja
nanus	kestävä
nationála	kansallinen
nađđii	isokahvainen
našunála	kansallinen
našuvnnalaš	kansallinen
nealggas	nälkäinen
nealggas	säälittävä
nealgái	nälkäinen
nearas	tylsä
neavri	huono
neavri	piru
negatiiva	negatiivinen
negatiivvalaš	negatiivinen
niestteheapme	eväätön
njalkkas	liukas
njaláhas	liukas
njarttas	läpimärkä
njeaccas	irvistävä
njealját	neljäs
njihtalas	petollinen
njirvvas	likomärkä
njivlái	limainen
njivlái	veltto
njoahci	hidas
njoaiddumus	loivin
njuolgat	suora
njuoskkas	märkä
njuovžžas	oppivainen
njuvvui	limainen
njálggat	makea
njálggis	hyvänmakuinen
njálggis	makeinen
njálmmálaš	suullinen
njáškkas	pitkänhuiskea
nohkkivaš	katoavainen
nohkkivaš	rajallinen
nollas	kykkivä
norgalaš	norjalainen
nubbi	toinen
nuorra	nuori
nuorttamus	itäisin
nuorttamus	pohjoisin
nuorttat	itäisempi
nuorttat	pohjoisempi
nuppelágán	toisenlainen
nurddas	tylppä
nurssas	tylppä
nurvui	nuhainen
nuvvalas	nuriseva
nákkis	ahdas
nárrii	riitaisa
nášuvnnalaš	kansallinen
náššuvnnalaš	kansallinen
oadjebas	turvallinen
oahccái	levollinen
oahcit	levollinen
oahpis	tunnettu
oahpis	tuttu
oahppameahttun	oppimaton
oahppameahttun	kovapäinen
oahppan	oppinut
oahppil	oppivainen
oaidnemeahttun	näkymätön
oaidnil	selvänäköinen
oainnus	näkyvä
oaktái	kuuroinen
oamedovddolaš	omantunnonarka
oamivánhurskkis	omahyväinen
oanehaš	lyhyt
oaraheapme	nuoraton
oardnji	kylmänarka
oarjjit	läntisempi
oarjjit	eteläisempi
oartnjas	kylmänarka
oatni	lyhyt
oavlái	väljä
oavsseheapme	oksaton
oavsseheapme	vähäoksainen
oaččálaš	lihallinen
obbalaš	yleinen
obmui	silmäkkeinen
ohkoladdalas	säntäilevä
ohkolahkes	säntäilevä
oktasaš	yhteinen
olgeš	oikea
olgguldas	ulkoinen
olggumus	uloin
olggut	ulompi
ollis	koko
ollis	kokonainen
ollis	aikuinen
ollislaš	täydellinen
olmmošlaš	kohtelias
oppa	kokonainen
oppalaš	yleinen
ordái	särmikäs
orrul	levollinen
oránša	oranssi
oskkolaš	uskovainen
otná	tämänpäivinen
otnáš	tämänpäivän
ovccát	yhdeksäs
ovddasteaddji	edustaja
ovddemus	ensimmäinen
ovddeš	entinen
ovddit	edellinen
ovttajienalaš	yksimielisesti
ovttalágan	samanlainen
ovttaskas	yksittäinen
ovttaárvosaš	samanarvoinen
ođas	uusi
ođđaivnnálaš	kirkkaanvärinen
ođđaáigásaš	uudenaikainen
ođđaáigásaš	moderni
ođđačalmmat	uudenkipeä
parlamentáralaš	parlamentaarinen
pedagogalaš	pedagoginen
persovnnalaš	henkilöllinen
politihkalaš	poliittinen
positiiva	positiivinen
positiivvalaš	positiivinen
praktihkalaš	käytännöllinen
prinsihpalaš	periaatteellinen
priváhta	yksityinen
priváhtta	yksityinen
psyhkalaš	psyykkinen
psykalaš	psyykkinen
rabas	auki
ranččas	puolialaston
rašši	arka
reahcas	harottava
reavas	herkkäuninen
reavgálas	röyhtäilevä
reavrras	länkisäärinen
reavvas	länkisäärinen
reavžžas	harottava
regionála	alueellinen
relevánta	relevantti
revgolas	röyhtäileväinen
riebas	pilaantunut
riekta	oikea
riektat	suorasyinen
rievttes	oikea
rihča	kitkerä
riidui	riitaisa
riidálas	kateellinen
riikkaidgaskasaš	kansainvälinen
riikkaviidosaš	maankattava
rikkis	rikas
rimssas	resuinen
rinzzas	pallovatsainen
rinččas	puolialaston
risttalaš	kristillinen
rivdal	väkevä
rivggas	riittoisa
riđđui	myrskyisä
riššui	hätiköivä
roahkkalas	koukkaileva
roahkkat	rohkea
roakkas	karhea
roakkas	möreä
roastil	uskalias
roattus	karhea
roattus	pelottava
roađđat	tulipunainen
roggái	kuoppainen
ropmi	ruma
rossii	puuskainen
rossui	puuskainen
ruccas	törkyinen
ruggii	sakkainen
ruhttái	rahakas
rumašlaš	ruumiillinen
ruobbái	rupinen
ruohppái	paakkuinen
ruohtis	karhea
ruohttalas	laukkova
ruoinnas	laiha
ruojus	kolkko
ruoksat	punainen
ruoná	vihreä
ruoppas	rupinen
ruovas	halkeillut
ruovjjeheapme	pieniraajainen
ruovjái	isoraajainen
ruošša	venäläinen
ruoššalaš	venäläinen
ruoŧa	ruotsalainen
russolas	pärskivä
russolas	pärskiväinen
ruvdii	korkealaitainen
ruvdnosaš	kruunuinen
ruđaheapme	rahaton
ruđaheapme	p.a.
ruđalaš	rahallinen
ruŋkálas	ronkkuva
ruškat	ruskea
rádjerihkot	raajarikkoinen
ráfeheapme	rauhaton
ráfálaš	rauhallinen
ráhkis	rakas
ráhppái	rapainen
ráiddolaš	raidollinen
ráiddolaš	raitomies
ráinnas	puhdas
ránis	harmaa
ránska	ranskalainen
ráttas	jääkylmä
rávddis	kireälypsyinen
rávis	aikuinen
ráđálaš	neuvokas
sadjásaš	sijainen
sahpit	jähmeä
sajiheapme	ahdas
seaggi	ohut
seahkálas	sekalainen
seahčat	suippo
sealas	lumeton
sealvi	selvä
sealvvas	selvä
seammaládje	samanlainen
seammalágan	samanlainen
seammalágán	samanlainen
seastevaš	säästäväinen
seasttaskas	säästeliäs
seavdnjat	tumma
seavdnjat	pimeä
servodatlaš	yhteiskunnallinen
servvolaš	osallinen
servvolaš	osakas
sesttolaš	säästäväinen
sieiddas	kosketuksenarka
sierra	erikseen
sierralágan	erilainen
sierranas	erikseen
sieđas	käheä
sieđus	käheä
sihkar	varma
sihkkar	varma
sihtavaš	vaativa
siidui	isokylkinen
siivui	kiltti
siskkáldas	sisäinen
siskálas	sisäkkäinen
sivaheapme	syytön
siviila	siviili
sivvat	varovainen
siđas	käheä
siđus	käheä
skeartnja	kärventynyt
skihčas	törröttävä
skirččas	luiseva
skiŋgil	kilkattava
skoarras	karvakulu
skoddui	sumuinen
skohččebealjat	pystykorvainen
skožas	pysty
skuittas	sojottava
skárttas	karstainen
smarvái	kiharainen
smiehttalas	mietteliäs
smiđis	lauha
smiđis	säyseä
smoahtis	mättäinen
smolgat	huoliteltu
smurtačáhppat	sysimusta
smáhkkui	lastuinen
smáiti	harmaakaihi
smávis	pikkuinen
smávis	pieni
smáđáhkes	mukava
snarras	haarova
snarras	eripurainen
sneavvar	vähäruokainen
snoakkis	niukka
snoakkis	kitsas
snoallái	rivo
snorras	kurttuinen
snuolgái	räkäinen
snárkkas	sykkyräinen
snárkái	sykkyräinen
soahkkái	koivuinen
soajeheapme	siivetön
soajeheapme	hihaton
soajálaš	siivellinen
soalssas	kuolaava
soalssas	kuolainen
soalsái	kuolaava
soalsái	kuolainen
sodnjái	riippaoksainen
sodnjái	roikkuvavaatteinen
sodnjái	rimsuvaatteinen
sogaheapme	suvuton
sojaheapme	taipumaton
somá	hauska
somá	kiva
somá	mukava
sorjavaš	riippumaton
sorjjas	riippuva
sorjjasmeahttun	riippumaton
sorpmálaš	hengenvaarallinen
sorpmálaš	tuhoisa
sorpmálaš	murhanhimoinen
sosiála	sosiaalinen
sosiálalaš	sosiaalinen
speaččas	latuskarintainen
spiertačáhppat	pikimusta
spuŋggas	pullottava
spuŋggas	punkeromainen
spállái	puuskainen
staigil	sävyisä
steaččas	litteä
stivrraheapme	kuriton
stoaljas	ääliömäinen
stoaljas	leväperäinen
stohkas	pökkelöitynyt
strategalaš	strateginen
stroaŋggis	ankara
stukkis	inhottava
stulkkas	kookas
stumppas	pullea
stuoris	iso
stuoris	suuri
stuorámus	suurin
sturrosaš	suuruinen
stáhppái	juovikas
stáhtalaš	valtiollinen
stáleheapme	teräksetön
stávrras	pitkänhuiskea
suddugas	syntinen
sudnjui	rimpinen
sujalaš	syyllinen
sujalaš	velallinen
suksii	huokoinen
sullasaš	samanlainen
sulolaš	suloinen
sulttas	pyylevä
suoddjái	suojaisa
suodnái	suonikas
suohkanlaš	kunnallinen
suohkat	sakea
suohkat	tiheä
suohtas	mukava
suohtas	hauska
suoidnái	heinäinen
suoldnái	kasteinen
suoldnái	usvainen
suollemas	salainen
suoládahkes	varastelevainen
suorggatlaš	kauhistuttava
suosas	riitteinen
suosttas	laho
suosttas	leväperäinen
suovrras	törkyinen
surolaš	surullinen
suttis	sula
suttolaš	syntinen
suttuheapme	synnitön
suvdi	kantava
suvdil	kantava
suvrris	hapan
systemáhtalaš	systemaattinen
sábmái	saamenmielinen
sádnái	runsassanainen
sádnái	kerkeäkielinen
sádnái	runsasleikkoinen
sáhppat	violetti
sáhppái	mehukas
sáhtehahtti	mahdollinen
sákkas	puikkomainen
sákkas	vähähaarainen
sáltteheapme	suolaton
sálttis	suolainen
sámegiel	saamenkielinen
sámegielalaš	saamenkielinen
sámegielat	saamenkielinen
sámepolitihkalaš	saamepoliittinen
sánálaš	sanallinen
sánálaš	henkinen
sánálaš	sanavalmis
sárdnái	puhelias
sávahahtti	toivottu
sávri	kestävä
teahtis	tiivis
teknihkalaš	tekninen
tiidii	taikauskoinen
tropihkalaš	trooppinen
turkalaš	turkkilainen
uddui	arpinen
uddui	kyhmyinen
udju	ujo
uhcagielagaš	puhevikainen
uhcci	pieni
uidni	kaino
ulbmillaš	määrätietoinen
ullui	villainen
uminddet	alaikäinen
umáhttu	taitamaton
unni	pieni
unohas	epämiellyttävä
unohas	hankala
ussel	kurja
ustitlaš	ystävällinen
ustitmeahttun	epäystävällinen
uvjjaheapme	untuvaton
uvjjaheapme	vähäuntuvainen
uvjái	untuvainen
vadni	venyvä
vahkkosaš	viikoittainen
vahátlaš	haitallinen
varaheapme	veretön
varaheapme	vähäverinen
varas	tuore
vašálaš	vihamielinen
veaddji	kestävä
veaddji	vaikutusvaltainen
veaddjil	vaikuttava
veaddjil	aamunvirkku
veadjemeahttun	mahdoton
veagaheapme	lannoittamaton
veagaheapme	väljähtynyt
veahkil	avulla
veahkálaš	avulias
veaittalas	paimentamaton
veajuheapme	voimaton
veajuheapme	huonovointinen
vealggeheapme	velaton
vealgugas	velallinen
vealit	ketterä
vearrái	paha
vearrái	hankala
vearuheapme	veroton
veasttamus	läntisin
veasttamuš	läntisin
veađar	kehittynyt
vejolaš	mahdollinen
velggolaš	velallinen
venzolas	vollottava
venzolas	vollottavinen
viehkalas	juoksevainen
vielgat	valkoinen
vieljalaš	veljellinen
vieris	vieras
viggalas	pyrkiväinen
vihaheapmi	vihkiminen
viiddis	laaja
viiddisis	laajahko
viidosaš	laajuinen
viissis	viisas
vilddas	villi
visot	kaikki
vissis	varma
vitmat	lahjakas
vitmat	tarkkasilmäinen
viđat	viides
viđát	viides
viššal	ahkera
viššal	viitseliäs
vuobmái	metsäinen
vuogas	sopiva
vuoiggalaš	rehellinen
vuoimmálaš	voimallinen
vuoiŋŋalaš	hengellinen
vuoksul	liinava
vuoksái	liinava
vuolgi	lähtevä
vuolimus	alimmainen
vuolimus	alin
vuolit	alempi
vuollegaš	matala
vuollásaš	alainen
vuopmat	leveä
vuordevaš	toiveikas
vuosttamus	ensimmäinen
vuosttamuš	ensisijaisesti
vuosttas	ensimmäinen
vuosttaš	ensimmäinen
vuovdái	metsäinen
vuovssaheapme	matala
vuđolaš	perusteellinen
vácceš	siveetön
váiban	väsynyt
váibbas	väsynyt
váibmil	perso
váibmil	ahne
váilevaš	puuttuva
váimmolaš	sydämellinen
váivi	ikävä
váivi	vaivalloinen
váldái	vallanhimoinen
váldái	omavaltainen
válljugas	mainio
válmmas	selkeä
válmmaš	selkeä
váralaš	vaarallinen
váreheapme	varaton
várrugas	varovainen
várrái	varakas
várálaš	vaarallinen
váttis	vaikea
vázzálas	kuljeskeleva
váŋká	vankka
áddehahtti	ymmärrettävä
áddemeahttun	ymmärtämätön
áhpeheapme	voimaton
áhppar	silkka
áhčálaš	isällinen
áidna	ainoa
áidnoriegádan	ainokainen
áidnu	ainoa
áigadas	ammoinen
áigeguovdil	ajankohtainen
áitálas	uhkaileva
álbmotlaš	kansallinen
álggalaš	alkeellinen
álggolaš	alkeellinen
álki	helppo
álás	alaston
álás	paljas
ánssolaš	ansiokas
ánssáškeahttá	ansaitsematon
árbbeheapme	perinnötön
árbevirolaš	perinteinen
árgi	arka
árgi	pelokas
árktalaš	arktinen
árpmolaš	armollinen
árrat	aikaisin
ártet	kummallinen
ártet	outo
árvosaš	arvoinen
árvvolaš	arvokas
ásialaš	aasialainen
ásppas	maittava
ávdin	autio
ávdugas	autuas
ávjjeheapme	heinätön
ávjjoheapme	tylsä
ávkkálaš	hyödyllinen
ávnnaslaš	aineellinen
ávvirheapme	välinpitämätön
ávvirmeahttun	välinpitämätön
áđat	parempi
áŋgir	ahkera
áššeheapme	syytön
áššeheapme	asiaton
áššeheapme	turha
čadni	sitova
čalmmeheapme	sokea
čatnasmeahttun	sitoutumaton
čavgat	kireä
čeahppi	taitava
čeahppi	etevä
čeaktu	täysinäinen
čeakŋas	kyykistelevä
čeakŋas	matalajalkainen
čearddalaš	etninen
čearggus	jännittävä
čeaskat	kirkas
čeavlái	ylimielinen
čeavlái	ylpeä
čiegus	salainen
čiegus	kätketty
čiekčalas	potkiva
čielggas	selvä
čielggus	selvä
čieŋal	syvä
čihččet	seitsemäs
čilssas	törröttävä
čirrolas	itkunherkkä
čižžái	rintava
čižžái	isotissinen
čoahkkat	tumma
čoaskkis	kylmä
čoasus	viileä
čoavjái	vatsakas
čoaŋkkas	kohmeinen
čogas	terävä
čomas	kupera
čomas	kukkurainen
čortnas	hutera
čujolaš	soinnillinen
čuorbi	kömpelö
čuorbi	taitamaton
čuovgat	valoisaa
čuovgat	vaalea
čuovggus	suosittu
čuovggus	valoisa
čuovggus	silmiinpistävä
čuovvovaš	seuraava
čuođát	sadas
čurttas	isopyllyinen
čurtái	isopyllyinen
čuvdda	löyhkäävä
čuvdda	löyhkä
čuvgesvuovttat	vaaleahiuksinen
čuvkui	juoksettunut
čába	kaunis
čáhccái	vetinen
čáhkkil	tilava
čáhppat	musta
čájeheaddji	esittävä
čálalaš	kirjallinen
čálekeahtes	kirjoittamaton
čáppat	kaunis
čáppis	kaunis
šaddi	nopeakasvuinen
šaddil	nopeakasvuinen
šattolaš	seuraaja
šeabmái	kailottava
šealgat	kiiltävä
šearrat	kirkas
šiega	kiltti
šiega	hyvätapainen
šiehttil	pienikokoinen
šiehtun	kiireetön
šiervi	hento
šiervvas	hento
šleđđui	tasankoinen
šlinzzas	pehmennyt
šloaŋggas	laiskanpulskea
šlurvvas	sottainen
šlurvvas	saamaton
šnjalččas	likomärkä
šnjarvvas	likomärkä
jagáš	vuotinen
finála	lopullinen
guovdageaidnulaš	koutokeinolainen
vuoras	vanha
kárášjohkalaš	kaarasjokelainen
várrogas	varovainen
finnmárkulaš	finnmarkkulainen
giitevaš	kiitollinen
veara	arvoinen
dákkáraš	tällainen
sivalaš	syyllinen
juogalágan	jonkinlainen
olgoriikalaš	ulkomaalainen
dohkketmeahttun	hyväksymätön
maŋŋelaš	myöhempi
deatnulaš	tenolainen
šállošahtti	valitettava
jámas	eloton
kilosaš	kiloinen
beakkálmas	kuuluisa
elektrovnnalaš	elektroninen
vázzi	kävelijä
suorggahahtti	pelottava
seksuálalaš	seksuaalinen
surgat	surullinen
duiskalaš	saksalainen
buotlágan	kaikenlainen
váidalahtti	valitettava
sosialisttalaš	sosialistinen
ruoŧŧelaš	ruotsalainen
dohkkemeahttun	kelvoton
rehálaš	rehellinen
aktiivvalaš	aktiivinen
kritihkalaš	kriittinen
áigásaš	aikainen
ohcejohkalaš	utsjokelainen
čorgat	siisti
virggálaš	virallinen
luovos	irtonainen
duppal	kaksinkertainen
amerihkálaš	amerikkalainen
musihkalaš	musikaalinen
balddihahtti	pelottava
gaskasaš	keskeinen
dearvvašlaš	terveellinen
etnalaš	etninen
áddjái	myöhäinen
rasisttalaš	rasistinen
geahppat	kevyt
ođđamállet	uusimallinen
áššálaš	syyllinen
eaŋkil	yksinkertainen
romantihkalaš	romanttinen
duhtameahttun	tyytymätön
dramáhtalaš	dramaattinen
veahkkái	avulias
ovttageardán	yksinkertainen
guovttelágan	erilainen
fysalaš	fyysinen
vigiheapme	syytön
badjelmearálaš	liioiteltu
namat	niminen
olgoriikkalaš	ulkomaalainen
áltálaš	alattiolainen
mielaheapme	hullu
ruonas	vihreä
máilmmiviidosaš	maailmanlaajuinen
eksohtalaš	eksoottinen
proffa	ammattimainen
juohkebeaivválaš	arkipäiväinen
seksuála	seksuaalinen
psykiátralaš	psykiatrinen
lodji	kesy
eahperehálaš	epärehellinen
klassihkalaš	klassinen
davvinorgalaš	pohjoisnorjalainen
agálaš	ikuinen
oktageardán	yksinkertainen
virgái	virallinen
mázelaš	masilainen
meariheapme	määrätön
teorehtalaš	teoreettinen
mangelágan	monenlainen
álbmotrievttálaš	kansainoikeudenmukainen
morálalaš	moraalinen
nuoraidpolitihkalaš	nuorisopoliittinen
juhkki	juovainen
realisttalaš	realistinen
almmus	julkinen
árjjalaš	innokas
ehtalaš	eettinen
birgemeahttun	voittamaton
suomagielat	suomenkielinen
statistihkalaš	tilastotieteellinen
medisiinnalaš	lääketieteellinen
konstruktiivvalaš	konstruktiivinen
virkui	reipas
váigat	tylsä
vuordemeahttun	odotuksematon
passiiva	passiivinen
bargguheapme	työtön
unjárgalaš	uuniemeläinen
hirpmus	hirveä
moivvas	epäselkä
meareheapme	ylimalkainen
diplomáhtalaš	diplomaattinen
etihkalaš	eettinen
nuoski	epäsiisti
kulturpolitihkalaš	kulttuuripoliittinen
jávoheapme	hiljainen
eahpelunddolaš	luonnoton
symbolalaš	symbolinen
originála	originaali
arkeologalaš	arkeologinen
kreatiivvalaš	kreatiivinen
kollektiivvalaš	kollektiivinen
oktonas	yksinäinen
fávru	kaunis
rievttálaš	oikeudenmukainen
siskkildas	sisäinen
njealječiegat	neliskanttinen
alternatiiva	vaihtoehtoinen
diekkáraš	tuollainen
teologalaš	teologinen
sirbmálaš	sirmalainen
ruonáeatnanlaš	grönlantilainen
guoros	tyhjä
eahpedábálaš	epätavallinen
romsalaš	tromssalainen
ulbmilaš	tavoitteellinen
románttalaš	romanttinen
kultturhistorjjálaš	kultuurihistoriallinen
eahpeformálalaš	epäformaalinen
mánnálaš	lapsellinen
ipmirmeahttun	ymmärtämätön
ođđalágan	uudenlainen
ortodoksalaš	ortodoksinen
islándalaš	islanttilainen
etnihkalaš	etninen
juvddálaš	juutalainen
gráfalaš	graafinen
váibmui	rohkea
teknologalaš	teknologinen
humoristtalaš	humoristinen
gánnihahtti	kannattava
veahkaválddálaš	väkivaltainen
radikála	radikaali
nállevealaheapmi	rasistinen
nággár	jääräpäinen
japánalaš	japanilainen
allaáiggálaš	allerginen
stáđis	vakaa
hánis	niuho
anárašgielat	inarinkielinen
seammasullasaš	samanlainen
kreatiiva	kreatiivinen
eurohpálaš	eurooppalainen
internašuvnnalaš	kansainvälinen
hávskái	mukava
girjjálaš	kirjallinen
áddetmeahttun	ymmärtämätön
guhkesáigásaš	pitkäaikainen
globála	maailmanlaajuinen
fysihkalaš	fyysinen
báneheapme	hampaaton
soabalaš	rauhallinen
sierralaš	erilainen
visuála	visuaalinen
tuiska	saksalainen
poehtalaš	poeettinen
magihkalaš	maaginen
geologalaš	geologinen
áššáigullevaš	asiaankuuluva
porsáŋgulaš	porsankilainen
filosofalaš	filosofinen
davvisámegielat	pohjoissaamelainen
konstruktiiva	konstruktiivinen
kanadalaš	kanadalainen
julevsámegielat	luulajansaamelainen
gáivuotnalaš	kaivuonolainen
davviriikalaš	pohjoismainen
álbmái	voimakas
álbmotrievttalaš	kansainoikeudenmukainen
speanta	jännittynyt
juonalaš	juonikas
nuortalašgielat	koltansaamenkielinen
klinihkalaš	kliininen
hámmárfeastalaš	hammerfestalainen
diehttalas	tietyinen
palestinalaš	palestinalainen
hollándalaš	hollantilainen
eahpedemokráhtalaš	epädemokraattinen
ideála	ideaalinen
guoirras	langanlaiha
allaárvosaš	aliarvoinen
leavdnjalaš	lemmijokelainen
konservatiiva	konservatiivinen
heivetmeahttun	sopimaton
globálalaš	globaalinen
fránska	ranskalainen
visuálalaš	visuaalinen
vealtameahttun	väistämätön
sisriikkalaš	sisämainen
dološáigásaš	arkaainen
behtolaš	petollinen
čavddis	tiivis
iešdáhtolaš	itsetahtoinen
genehtalaš	geneettinen
byrokráhtalaš	byrokraattinen
regiovnnalaš	alueellinen
modearna	uudenaikainen
jurddašeaddji	ajattelevainen
iešlágan	kummallinen
anárlaš	inarilainen
anihahtti	kelvollinen
spánskalaš	espanjalainen
psykologalaš	psykolooginen
analoga	analoginen
máŋggakultuvrrat	monikulttuurinen
internationála	kansainvälinen
homofiillalaš	homofiilinen
ámmátlaš	ammatillinen
nuppelágan	erilainen
liberála	liberaali
italialaš	italialainen
gáđaš	kateellinen
giellapolitihkalaš	kielipoliittinen
dramatihkalaš	dramaattinen
buorredáhtolaš	hyväntahtoinen
kontroversiealla	kiistanalainen
kiinnálaš	kiinalainen
federála	federaalinen
estehtalaš	esteettinen
anonyma	nimetön
neutrála	neutraali
lujávrilaš	luujärveläinen
kommersiealla	kaupallinen
humanisttalaš	humanistinen
anatomalaš	anatominen
suivat	tylsä
skibas	sairaalloinen
oinnolaš	erillinen
gutneheapme	törkeä
groavis	karkea
eahperealisttalaš	epärealistinen
diehtoáŋgir	utelias
árvvoheapme	vaikea
valli	nopea
ironalaš	ironinen
humaniteara	humanitaarinen
elektrihkalaš	sähköinen
villas	villi
smáđáhkis	mukava
primitiiva	primitiivinen
mekánalaš	mekaaninen
gutnálaš	kunniallinen
tuiskalaš	saksalainen
šoavkat	kalpea
subjektiivvalaš	subjektiivinen
ovttagielat	yksikielinen
návccaheapme	heikko
meteorologalaš	säätieteellinen
profeššunealla	ammattimainen
ovttamielalaš	yksimielinen
normála	normaali
lappalaš	lappalainen
eahpeáššálaš	asiaton
spánska	espanjalainen
regionálalaš	alueellinen
dearvvaslaš	terveellinen
viđajahkásaš	viisivuotinen
stabiila	vakaa
objektiivvalaš	objektiivinen
nuoraidpsykiátralaš	nuorisopsykiatrinen
máŋggagielat	monikielinen
musikálalaš	musikaalinen
lutherána	lutherilainen
inhabiila	jäävi
indialaš	intialainen
golmmagielat	kolmekielinen
agálaččat	ikuisesti
agás	iäksi
ahkásii	iäksi
aiddo	juuri
aiddonassii	varsinaisesti
aiddostassii	varsinaisesti
ain	vielä
ain	yhä
ainge	yhäkin
aivvefal	pelkästään
aktiivvalaččat	aktiivisesti
alimahtes	lanteilla
alimas	lanteilla
allagit	korkeasti
almmatge	kuitenkin
almmá	ilman
altteson	kunpa
annes	annas
anus	käytössä
arvat	paljon
assájit	paksulti
attás	lahjaksi
badjelii	yli
bahčinviđá	vastalypsettynä
baicca	mieluummin
bajil	päällepäin
bajás	ylös
beaivet	päivällä
beaivet	päivisin
beaivit	päivällä
beaivit	päivisin
beaivváhala	päivälleen
beaivválaččat	päivittäin
beanta	suorastaan
beare	liian
beare	vain
belohahkii	osittain
birrageavlái	ympyrää
birrasii	tienoilla
birrasii	noin
boakkil	väärällä
boalččil	kampuralla
boastut	väärin
buhttásit	puhtaaksi
buohkanassii	kaikkiaan
buohkanassii	kokonaisuudessaan
buokčagasas	sukelluksissa
buokčagassii	sukelluksiin
buorebut	paremmin
buoremusat	parhaiten
buoret	mieluummin
buoret	paremmin
buot	kaikki
buot	kaikkein
bures	hyvin
báikkiid	suunnilleen
báikkohagaid	paikoitellen
báikkuid	paikoin
báikkálaččat	paikallisesti
báljo	paljon
ceahkkálagaid	asteittain
dainna	sillä
dakka	juuri
dakkaviđe	heti
dakko	siinä
dal	nyt
dalle	sitten
dalle	silloin
dalán	heti
dalánaga	heti
danin	siksi
danne	siksi
dasa	siihen
dasto	sitten
dasttá	heti
datte	silti
dattetge	kuitenkin
davvin	pohjoisessa
davábealde	pohjoispuolella
davás	pohjoiseen
dađi	sitä
dađistaga	vähitellen
de	kyllä
de	sitten
dearvan	terveenä
deike	tänne
deikke	tänne
die	tuolla
diehke	tänne
diehko	sinne
diehttelas	tietysti
diehttevassii	tiedoksi
diekko	siinä
diesa	siihen
dievva	täynnä
dievvasit	täydelleen
dieđus	tietysti
dieđusge	tietenkin
diimmohala	minuutilleen
divvosupmái	korjatuksi
divvumassii	korjatuksi
doaisttážii	toistaiseksi
doarrás	poikittain
doarvái	tarpeeksi
dobbelii	sinnemmäs
dohko	sinne
dohkálaččat	kelvollinen
doiste	toiste
dolin	ennenvanhaan
dolin	muinoin
doppe	siellä
doppe	tuolla
doppimustá	kaukaisimmillaan
doppit	kaukaisempi
duhkodagas	ulottuvilla
duhkodahkii	ulottuville
duhtosii	tosissaan
duo	tuolla
duobbelii	tuonnemmas
duohken	takana
duohko	tuonne
duohkái	taakse
duohta	totta
duohta	tosi
duohttige	todella
duohttáge	todella
duohččagasas	säästössä
duohččagassii	säästöön
duohččasii	säästöön
duohččasis	säästössä
duolbasii	levälleen
duoppit	tuonnempi
duosa	tuohon
duođai	todella
duođai	tosiaan
duođaid	todella
duođas	todellinen
duođi	tuota
duvle	äskettäin
duvle	taannoin
duđđái	kuhnaileva
duđđái	hössöttävä
duŋgadassii	tönköksi
duŋgasii	tönköksi
dušše	vain
dušše	ainoastaan
dá	tässä
dábálaččat	tavallisesti
dádjat	taannoin
dáigá	taikaa
dákko	täällä
dál	nyt
dálge	nytkin
dálvelii	talvemmas
dálvet	talvella
dálvit	talvella
dálánaga	heti
dáppe	täällä
dáppe	täältä
dárbahassii	tarpeeksi
dárbbašmeahttumit	tarpeettomasti
dárkileappot	tarkemmin
dárkilit	tarkasti
dás	tässä
dás	tästä
dása	tähän
dávjjit	useammin
dávjá	usein
eahkedis	illalla
eahkes	illalla
ealáskahttindihtii	elvyttämiseksi
eambbo	enemmän
eambu	enemmän
eambu	pikemminkin
eanas	yleensä
eanaš	enimmäkseen
eanemus	enimmäkseen
eanemusat	eniten
eanemustá	eniten
eanet	enemmän
eanet	useampi
eanáš	enimmäkseen
earalágan	erilainen
earenoamážit	erityisesti
easkka	vasta
easkka	äsken
easkka	juuri
easkká	äskeinen
ein	yhä
erenoamážit	erityistä
eret	pois
eske	äsken
fal	vain
farga	kohta
farga	pian
farga	nopeasti
fargga	kohta
fargga	pian
fargga	nopeasti
fas	taas
fas	puolestaan
ferot	valmis
finakeahttá	käymättä
funet	huonosti
fuolas	huolissaan
fuođđit	huokealla
fáhkkestaga	yhtäkkiä
fárus	mukana
fávlil	ulompaa
gal	kyllä
gale	kyllä
galhan	kyllähän
gallás	kylliksi
gallás	täyteen
garrasit	kovasti
garrasit	kovaa
gaskal	keskellä
gaskamearálaččat	keskimääräisesti
gaskkohagaid	välillä
gasku	keskellä
geahppadit	kevyesti
geallagasas	kiillotettuna
geallagassii	kiillotetuksi
geardde	kerran
geasset	kesällä
geassit	kesällä
geassit	kesäisin
geavllil	kaarella
geavllil	kaartaen
gieskat	hiljattain
gitta	kiinni
giđđat	keväällä
giđđat	keväisin
goappos	kumpaalle
goas	koska
goas	milloin
goasii	lähes
goasse	koskaan
goassege	koskaan
goitge	kuitenkin
gokko	mistä
gos	missä
gos	mistä
gosa	minne
gosage	mihinkään
gosge	mistään
got	miten
got	kuinka
govvái	yllätyksekäs
guhkit	pidempi
guhkkin	pitkällä
guhkkin	kaukana
guhká	kauan
guhkás	kauas
guita	sujut
guktii	kahdesti
gulul	hiljaa
gulul	hitaasti
gulámuddui	kuuloetäisyydelle
gulámuttos	kuuloetäisyydellä
guoggarasas	kyyryssä
guoggarassii	kyyryyn
guovttá	kahden
guovttá	kahdestaan
gusto	näköjään
gusto	näet
guđadassii	kuudenneksi
gáddil	rannempaa
gáidagasas	loitolla
gáidagassii	loitos
gánske	ehkä
gárremaččaide	hiprakkaan
gárremaččain	hiprakassa
gárvásii	valmiiksi
heahpat	häpeä
healla	kuoliaaksi
hihtásit	hitaasti
hiljážii	hiljakseen
hirbmadit	kovasti
hirbmadit	kovin
hirbmat	hirveä
hirbmat	hirmuinen
hirril	harallaan
hoahpus	nopeasti
hoahpus	pian
hui	erittäin
hui	hyvin
háhttásii	ahtaalle
háhttásis	ahtaalla
hájilassii	hajallaan
hárrut	harallaan
hárve	harvoin
hárčut	haarallaan
hávil	kerralla
hávil	kerrallaan
ihcalassii	itsekseen
ihcalassii	itsestään
ihkku	yöllä
ihkku	öisin
ihttin	huomenna
ihttážii	huomiseksi
ikte	eilen
illá	tuskin
iskor	hirveän
iđedassii	aamuksi
iđedis	aamulla
iđđedis	aamulla
iđđes	aamulla
jahkásaččat	vuosittain
jalga	suoraan
jarkŋil	pullistunut
jitnosii	ääneen
jitnosit	ääneen
jitnosit	äänekkäästi
jo	jo
johtilit	nopeasti
joksege	jokseenkin
jođánit	nopeasti
juhkamassii	juovuksiin
julggal	julkisesti
juo	jo
jur	juuri
justa	tarkalleen
justa	juuri
juste	juuri
lagabui	lähempi
lahkosis	lähellä
lasi	lisää
liikká	siltikin
liikká	kuitenkin
loahpalaččat	lopullisesti
loahpas	lopuksi
loaidulii	loidommas
logakeahttá	lukematta
luksa	etelään
luksa	itään
lulde	etelässä
lullil	etelämpää
lullil	idempää
lulábealde	eteläpuolella
lulás	etelään
lunddolaččat	luonnollisesti
láhjás	lahjaksi
láhppagasas	kadoksissa
láhppagassii	kadoksiin
láhpposii	kadoksiin
láhpposis	kadoksissa
lámas	raajarikoksi
lápmálassii	raajarikoksi
mahkáš	mukamas
maid	myös
maiddái	myös
maiddái	myöskin
man	kuinka
manin	miksi
manne	miksi
mannolagas	kulkeilla
mannolahkii	kulkeille
masa	mihin
masá	melkein
masá	miltei
maŋemus	viimeinen
maŋŋel	jälkeen
maŋŋit	myöhään
maŋŋá	myöhemmin
mealgat	melko
measta	melkein
measta	lähes
meattá	ohi
menddo	kaukana
menddo	liian
miehtut	pitkittäin
mielde	mukana
mielde	mukaan
mihá	melko
mista	vahingossa
mo	miten
mo	kuinka
moktige	mitenkään
movt	miten
muhtumin	joskus
muhtumin	toisinaan
muđui	muuten
muđuid	muuten
máddelažžii	etelämmäs
máddelii	etelämmäs
máddil	etelämpää
mái	kylläkin
mánnosaččat	kuukausittain
máttás	etelään
máŋgii	monesti
mášoheamet	malttamattomasti
naba	entä
naba	entäpä
namalassii	erityisesti
namalassii	nimittäin
nammejahkii	nimeltä
nammejahkii	nimenomaan
nannosit	lujasti
nannosit	varmasti
nappo	siis
nas	entä
nie	niin
nie	siten
nirvvil	virneessä
nissonahttá	emännättä
njahppasii	...tarttuneeksi...
njamažahkká	yllättäen
njavvái	nivainen
njoazit	hitaasti
njozet	hitaasti
njulgestaga	suorastaan
njulgestaga	suoraan
njuolga	suora
njuolgga	suoraan
njálgát	makeasti
njálmmálaččat	suullisesti
njárbadit	harvakseltaan
nohkka	tarpeeksi
nu	niin
nu	näin
nuogis	tarpeeksi
nuoluid	kapaloimattomana
nuortalii	idemmäs
nuortalii	pohjoisemmas
nuortan	idässä
nuorttas	itään
nuorttas	pohjoiseen
nuppos	toisaalle
nuvttá	ilmaiseksi
ná	näin
ná	no
oainnat	näet
oalle	varsin
oalle	sangen
oalát	täydellinen
oarjil	lännempää
oarjil	etelämpää
oarjin	lännessä
oarjjabealde	länsipuolella
oavnnjil	tuntumassa
oavnnjil	perässä
oba	melko
obbalaččat	yleisesti
obbalohkái	ollenkaan
obbanaga	kokonaisena
odne	tänään
oidnosii	näkyviin
oidnosis	näkyvissä
oktan	yhdessä
oktii	kerran
oktii	yhteen
oktii	vastakkain
oktiibuot	yhteensä
okto	yksin
olggos	ulos
olgul	ulompaa
olgun	ulkona
ollege	ollenkaan
ollege	lainkaan
ollislaččat	kokonaan
ollodahkii	mittaan
ollu	paljon
ollásit	täydellinen
olu	paljon
olus	juuri
olus	paljon
olus	paljonkaan
omd	esimerkiksi
on	taas
otne	tänään
ovccádassii	yhdeksänneksi
ovdagihtii	etukäteen
ovdal	ennen
ovdalaš	aikaisemmin
ovdalii	edemmäs
ovdalii	edelle
ovdan	eteen
ovddabealde	etupuolella
ovddalgihtii	etukäteen
ovddas	edessä
ovddas	edestä
ovddimustá	aikaisintaan
ovddimustá	ensimmäisenä
ovddimustá	pikimmin
ovddosguvlui	eteenpäin
ovstalii	idemmäs
ovtta	yhteinen
ovttajienalaččat	yksimielisesti
ovttas	yhdessä
ovttatmanos	yhtäkyytiä
ođđasis	uudestaan
ođđasit	uudestaan
persovnnalaččat	henkilökohtaisesti
rabas	avoin
reaŋggaš	renkeineen
riekta	oikein
rievttabut	oikeammin
roahkkut	ristissä
roahtá	äkisti
ruoktot	kotiin
ruoktot	takaisin
ruoktut	kotiin
ruossut	ristiin
ruovttoluotta	takaisin
ruovttus	kotona
ruvva	äkkiä
rádjerihkku	raajarikoksi
ráđđái	neuvokas
sahtedohko	satunnainen
sakka	kovasti
sealggálassii	selälleen
seamma	sama
seammás	samalla
seammás	samassa
sierra	erinomainen
sihkkarit	varmasti
sisa	sisään
siskkabealde	sisäpuolella
siskkáldasat	sisäisesti
siste	sisällä
siste	sisältä
sisti	sisällä
skaippil	kierossa
skeaŋkkas	lahjaksi
skoavddil	komolla
smávvásiid	vähittäin
sneakta	poikki
snogastahkii	etukenossa
so	niin
sodjagasas	painuksissa
sodjagassii	painuksiin
sulaid	noin
sulaid	suunnilleen
sullii	suunnilleen
sullii	noin
suoimmal	loivasti
suoli	salaa
suoli	salaisesti
suollit	salaa
sámás	saameksi
sárdnumassii	puhuttavaksi
taga	ilman
uhccán	vähän
uhcimus	vähiten
uhcimusge	vähintäänkin
uhcit	vähemmän
uheavás	tarpeettomasti
unnimusat	vähintään
unnimusge	vähintäinkin
unnit	vähemmän
unnán	vähän
vahkkosaččat	viikoittain
vaikke	vaikka
vaikko	vaikka
valjit	runsaasti
varasnaga	tuoreeltaan
veagal	väkisin
veahá	vähän
veaháš	vähän
vealggás	velaksi
vealttakeahttá	välttämättä
veastal	lännempää
veastalii	lännemmäs
veasttas	länteen
veháš	vähän
vejolaččat	mahdollisesti
vel	vielä
velgo	vieläkö
velá	vielä
veret	väärin
viehka	melko
viehka	aika
vihttii	viidesti
viidáseappot	edelleen
viidáseappot	eteenpäin
viidáset	eteenpäin
viidásit	laajalti
viidát	laajalti
viimmat	vihdoin
viimmat	viimein
viisásit	viisaasti
villavákkus	vahingossa
visot	kaikki
vissa	kai
vissa	varmaankin
vissásit	varmasti
viđadassii	viidenneksi
vuhtii	vastaan
vulos	alas
vulos	alaspäin
vuohččan	ensimmäinen
vuollin	alhaalla
vuolábealde	alapuolella
vuolás	alas
vuordagasas	odotettavissa
vuos	vielä
vuos	ensin
vuosttasin	ensimmäisenä
vuosttažettiin	ensiksi
vuot	taas
vuotnalaš	onnekas
vuovdimassii	myynnissä
vádjit	vaille
váhá	vähän
váibamassii	väsyksiin
váile	vaille
váillil	vajaana
vánit	niukasti
vári	varalta
várra	ehkä
várra	varmaan
várra	varmaankin
várrugasat	varovasti
vásedin	tahallaan
vátni	tuskin
áibbas	aivan
áibbas	ihan
áiggebále	ajoissa
áiggil	ajoissa
áimmuin	tallella
áinnas	ehdottomasti
álelassii	ainaisesti
álggos	aluksi
álggos	ensin
áli	aina
álkit	helppo
álo	aina
álohii	aina
álot	aina
ándagassii	anteeksi
árrat	ajoissa
áŋgirit	ankarasti
čakčat	syksyllä
čakčat	syksyisin
čatnagasas	sidoksissa
čatnagassii	sidoksiin
čađat	aina
čeagŋut	kyykyssä
čeahpit	taitavasti
čeavžái	koukkukinttuinen
čielga	selkeä
čoahkis	kasassa
čoahkkái	kokoon
čorrut	syrjällään
čábbát	kauniisti
čálalaččat	kirjallisesti
šat	enää
šiehppun	kiireetön
šlumpa	umpimähkään
šnjorrosii	liristen
ahte	että
dahe	taikka
dahje	taikka
daihe	taikka
daikke	taikka
ja	ja
muhto	mutta
vaikke	vaikka
vaikko	vaikka
sihke	sekä
dehe	tai
vai	vai
ahte	että
amas	outo
go	kun
go	kuin
jos	jos
juogo	joko
juos	jos
nugo	kuten
vaikko	vaikka
josgo	josko
váikko	vaikka
dego	kuten
jus	jos
giitu	kiitos
juo	kyllä
juo	jo
já	jaa
oaidnaleapmái	näkemiin
cuš	hoi
fihcce	hyi
fuoi	hyi
fuos	hus
hei	ohhoh
hoi	hohoi
huf	huh
hyš	hys
skolle	kippis
buorat	päivää
buorat	terve
dearvva	terve
dearvva	moi
attášitgo	antaisitko
dallege	silloinkin
dallehan	silloinhan
dallenai	silloinkin
duođaige	todellakaan
duođaige	tosiaankaan
earáge	muutakin
goaseai	lähes
gosabat	mihinkä
gosabat	minnekä
nuge	niinkään
ollugo	paljonko
vuorddemat	odotahan
vuorddemat	odotapas
vuorddesmat	odotapas
bassi	siivoja
lohkki	lukija
vuovdi	myyjä
rišša	tulitikku
rišša	rikki
Afrihká	Afrikka
Albánia	Albania
Anár	Inari
Austrália	Australia
Bargiidbellodat	Työväenpuolue
Belgia	Belgia
Biŧon	Piitime
Boahji	Pohjantähti
Bulgária	Bulgaria
Darji	Turja
Deatnogáddi	Tenonranta
Deatnu	Teno
Duiska	Saksa
Dánmárku	Tanska
Dávggát	Otava
Girkonjárga	Kirkkoniemi
Giron	Kiiruna
Guovdageaidnu	Koutokeino
Guovddášbellodat	Keskustapuolue
Gurutbellodat	Vasemmistopuolue
Gárasavvon	Kaaresuvanto
Gáregasnjárga	Karigasniemi
Ipmil	Jumala
Norga	Norja
Olgešbellodat	Kokoomus
Ovddádusbellodat	Edistyspuolue
Ođđasat	Uutiset
Roavvenjárga	Rovaniemi
Ruonáeana	Grönlanti
Ruošša	Venäjä
Ruoŧŧa	Ruotsi
Soađegilli	Sodankylä
Stuorradiggi	Suurkäräjät
Suopma	Suomi
Sámediggeráđđi	Saamelaisneuvosto
Sámediggi	Saamelaiskäräjät
Sápmi	Saamenmaa
abessiiva	abessiivi
ablatiiva	ablatiivi
abohtta	apotti
abskissa	abskissa
addi	antava
addi	antaja
adjektiiva	adjektiivi
administrašuvdna	hallinto
admirála	amiraali
adreassa	osoite
adveanta	adventti
advearba	adverbi
advokáhta	asianajaja
ahki	ikä
ahkitvuohta	ikävyys
akademihkar	akateemikko
akkusatiiva	akkusatiivi
akustihkka	akustiikka
akšuvdna	liike
albbas	ilves
albmasuoigi	ruumiinvamma
albmasuoigi	turma
albmeassi	taivaankansi
albmi	taivas
albmáimannan	taivaaseenastuminen
aldna	ien
alfabehta	aakkoset
algoritma	algoritmi
alitrássi	metsäkurjenpolvi
alkohola	alkoholi
alkoholisma	alkoholismi
alkoholista	alkoholisti
allamielalašvuohta	ylimielisyys
allaskuvla	korkeakoulu
allatiiva	allatiivi
allatvuohta	korkeus
allergiija	allergia
allodat	korkeus
allodatnjuiken	korkeushyppy
almmenáhkki	almanakka
almmiguovlu	taivaansuunta
almmiriika	taivaanvaltakunta
almmivierca	taivaanvuohi
almmolašvuohta	julkisuus
almmuheapmi	julistaminen
almmuhus	ilmoitus
almmái	mies
almmáiolmmoš	mies
alumiidna	alumiini
aládas	koroke
ambulánsa	ambulanssi
ampera	ampeeri
analogiija	analogia
analysa	analyysi
anatomiija	anatomia
anemiija	anemia
anteanna	antenni
antihkka	antiikki
antologiija	antologia
anáraš	inarinsaamelainen
anárašgiella	inarinkieli
anárašgiella	inarinsaamenkieli
apostal	apostoli
apotehkár	apteekkari
appelsiidna	appelsiini
arena	areena
argumeanta	argumentti
aritmetihkka	aritmetiikka
arkeologa	arkeologi
arkeologiija	arkeologia
arkiiva	arkisto
arkiteakta	arkkitehti
arkitektuvra	arkkitehtuuri
arnihkka	arnikki
artihkal	artikkeli
artista	artisti
arvebivttas	sadevaatteet
arvedálki	sadeilma
arvedávgi	sateenkaari
arveoakti	sadekuuro
arvi	sade
arába	arabi
asbeasta	asbesti
asfálta	asfaltti
asibealli	kesipuoli
aski	syli
aspárggus	ruokaparsa
assisteanta	assistentti
assosiašuvdna	assosiaatio
astoáigeklubba	iltapäiväkerho
astronávta	avaruusmies
ateisma	ateismi
ateista	ateisti
atnin	käyttö
atnu	käyttö
atoma	atomi
attribuhtta	attribuutti
attus	almu
attáldat	lahja
automatiseren	automatisointi
automáhtta	automaatti
autoritehta	auktoriteetti
aviisa	lehti
aviisa	sanomalehti
avvi	vyö
avádat	vyöhyke
ađa	ydin
badjebáza	ylijäämä
badjedilli	porotalous
badjedilli	paimentolaisporonhoito
badjegánda	poropoika
badjelbáza	ylijäämä
badjeliigeahčči	valvoja
badjeolmmoš	poronhoitaja
badjeolmmoš	porosaamelainen
badjesápmelaš	porosaamelainen
badjosat	ylänkö
badjosat	ylämaa
badni	kehrääjä
bagadallan	ohjaus
bagadalli	ohjaaja
bagadas	tiiviste
bagadeaddji	ohjaaja
bagadeapmi	kuritus
bagadeapmi	neuvonta
bagadus	ohje
baggi	pullukka
bahodat	pahuus
bahta	pylly
bahta	takapuoli
bahta	perse
bahágas	paholainen
bahálaš	pahus
bahčči	lypsäjä
baika	paska
baikabava	ummetus
baikačivga	räkänokka
bajildus	päällinen
bajildus	päällys
bajilčála	otsikko
bajuš	yläosa
bajádus	nostettava
bajálaš	väliraha
bajálaš	lisuke
bajálaš	jälkiruoka
baján	ukkonen
bajándálki	ukkonen
bajándálki	ukkosilma
bajándávgi	sateenkaari
bajásdoalahus	ylläpito
bajásráhkadus	ylösrakennus
bajásčuožžileapmi	ylösnousemus
bakku	pyy
balddonas	kummitus
baldu	jäälautta
baldu	jääteli
ballu	pelko
balláda	balladi
balsámabohppel	palsamipoppeli
balva	pilvi
balánsa	tasapaino
bankiira	pankkiiri
banáhat	kehräämö
banána	banaani
barbára	barbaari
barddáldat	ladelma
barganáigi	työaika
barggolašvuohta	työllisyys
bargguhisvuohta	työttömyys
bargi	työntekijä
bargi	työläinen
bargiidbellodat	työväenpuolue
bargoaddi	työnantaja
bargobeaivi	työpäivä
bargobierggas	työkalu
bargobihttá	työtehtävä
bargobihttá	harjoitus
bargobiras	työympäristö
bargobivttas	työvaatteet
bargobáiki	työpaikka
bargodepartemeanta	työministeriö
bargodilli	työolosuhde
bargoeallin	työelämä
bargoheaitta	lakko
bargojoavku	työryhmä
bargolávdegoddi	työlautakunta
bargoplána	työsuunnitelma
bargosadji	työpaikka
bargoskihpár	kollega
bargosuorgi	työllistämiskerroin
bargoveahka	työvoima
bargovuohki	työtapa
bargu	työ
barju	tunturilainen
barohkka	barokki
barta	mökki
basadangárri	lavuaari
basadanlatnja	kylpyhuone
basahat	pesula
basaldat	pesurätti
basilla	basilli
bassaladdanmášiidna	pesukone
bassangárri	lavuaari
bassanálddis	lavuaari
bassančáhci	pesuvesi
bassenmuorra	paistinvarras
bassi	pyhä
bassinmuorra	makkaratikku
bassivuohta	pyhyys
baste	lusikka
bastilislátnjá	orjantappura
bataljovdna	pataljoona
bavssa	huuli
bađuš	pyrstö
bađvi	palko
baška	paska
beaggin	maine
beahcebáhcat	männynkäpy
beahci	mänty
beahttu	petos
beahtu	peto
beahtus	petos
beaika	pyökki
beaisku	tuholainen
beaivegirji	päiväkirja
beaiveloddi	perhonen
beaiveruoktu	päiväkoti
beaivi	päivä
beaivi	aurinko
beaivvádat	auringonpaiste
beaivváš	aurinko
beaivvášláibbáš	aurinkopulla
beakkohus	huhu
beaktu	teho
bealaš	väliraha
bealbi	vesitatar
bealdu	pelto
bealgi	peukalo
bealgi	isovarvas
bealjehisvuohta	kuurous
bealjehisvuohta	huonokuuloisuus
bealle	puoli
beallelaš	puoliso
beallemas	pellava
beallemuddu	puoliväli
bealli	puoli
bealli	puolikas
bealljerokkan	vaaksiainen
beallji	korva
bealládat	puolue
bealušteaddji	puolustaja
bealátkeahtesvuohta	puolueettomuus
bealátvuohta	puolueellisuus
beana	koira
beanaráidu	koiravaljakko
beanna	kynä
beantá	tukikeppi
beara	päre
bearal	helmi
bearatgoddi	perhekunta
bearaš	perhe
bearašdepartemeanta	perheministeriö
beargalat	perkele
bearjadat	perjantai
bearragoddi	perhekunta
beaska	peski
beassan	pääsy
beassanláhki	pääsy
beassanvuohta	pääsy
beassegatna	koivunkylkijäkälä
beassi	pesä
beassi	tuohi
beassášbeaivi	pääsiäispäivä
beassášluopmu	pääsiäisloma
beassášlávvardat	pääsiäisilta
beassášlávvardat	pääsiäisaatto
beassášlávvordat	pääsiäisilta
beassášlávvordat	pääsiäisaatto
beassášmárkan	pääsiäismarkkina
beassášmátki	pääsiäisretki
beassášruohtta	pääsiäisilta
beassášruohtta	pääsiäisaatto
beassážat	pääsiäinen
beatnagaš	koiranen
beatnatdaŋas	ruohokanukka
beatnatgieldá	katinlieko
beatnatgullan	peninkulma
beatnatrávra	järviruoko
beatnatrávra	pallerokoiranheinä
beavddáš	pöytänen
beavdebiigá	tarjoilija
beavdegirji	pöytäkirja
beavdeliidni	pöytäliina
beavdeliidni	liina
beavdi	pöytä
beavža	itätuuli
beađbi	lapaluu
beaŋka	penkki
beaŋka	tuoli
behkeš	kehräsluu
bejot	valkko
belko	hakkuupölkky
bellodat	puolue
bellodatustit	puoluetoveri
beloštus	puolustus
belá	serkku
benne	penni
bensiidna	bensa
bensiidna	bensiini
beroštupmi	kiinnostus
beroštus	huoli
beroštus	kiinnostus
bessodat	vitsas
bessodat	mäystin
beste	pesti
betoŋga	betoni
beđoohtte	tasakertahirsi
beškkoš	pääskynen
beštor	västäräkki
bibliografiija	bibliografia
bibliotehka	kirjasto
bidjet	huutokauppa
biebmanluokti	ruokintakatos
biebmodepartemeanta	ruokaministeriö
biebmoealli	lemmikkieläin
biebmoealli	lemmikki
biebmolistu	ruokalista
biebmu	ruoka
biedju	pesä
biegga	tuuli
biehkan	piekana
biehtarasdilljá	atlasnikama
biehttalus	kieltäymys
biehttalus	pidättäytyminen
biehtárguhkká	siankärsämö
biehtárrássi	siankärsämö
bieksu	pieksu
biellohas	kellokas
biellorássi	kissankello
biellu	kello
biellán	kellokas
biepmohas	kasvatti
bierdna	karhu
bierdni	karhunpoika
bierggas	esine
biergogievdni	lihapata
biergoláibi	lihavoileipä
biergomális	lihakeitto
biergomálli	lihakeitto
biergoskadjá	lihavaja
biergoskadjá	lihatalas
biergu	liha
biestta	pensas
bievla	pälvi
biffa	pihvi
biggoheapmi	ilmanvaihto
bigán	äkkipikainen
bihcebáhce	käpy
bihkaš	tervas
bihkka	terva
bihpar	pippuri
bihppor	pippuri
bihpporbiffa	pippuripihvi
bihpporgáhkku	piparkakku
bihpporgáhkku	piparit
bihttá	pala
bihttá	palanen
bihttá	pykälä
bihtánsámegiella	piitimensaame
biibal	raamattu
biibbal	raamattu
biigá	piika
biika	piikki
biila	auto
biiladivohat	autokorjaamo
biiladivohat	korjaamo
biilagávpi	autokauppa
biilaskuvla	ajokoulu
biilavuoddji	autonajaja
biilačoavdda	autonavain
biilačoavdda	autonavaimet
biire	piiri
biire	paliskunta
bileahtta	lippu
bilka	pilkki
bilkideaddji	pilkkaaja
bilku	pilkka
billašupmi	turmelus
billár	tuholainen
bindda	heittiö
bindda	pinne
binná	vähän
biologa	biologi
biotohpa	biotooppi
bipmi	piimä
biras	ympäristö
birasgáhtten	ympäristösuojelu
birasgáhttenministtar	ympäristöministeri
birasoahppu	ympäristöoppi
birasviessu	ympäristötalo
bircu	kuutio
birgemuš	toimeentulo
birgenláhki	toimeentulo
biro	piru
birrabeaivi	vuorokausi
birrabotnjalus	kääntymys
birradat	piiri
birračuohpahus	ympärileikkaus
bisma	piispa
bismmáčoahkkin	piispantarkastus
bismárra	puntari
bispa	piispa
bissu	pyssy
bistu	kesto
bivastat	hiki
bivdda	pyyntö
bivddus	pyydys
bivdi	kalastaja
bivdi	metsästäjä
bivdi	pyytäjä
bivdinmuddu	pyyntietäisyys
bivdinvuohki	pyyntitapa
bivdoguovlu	pyyntialue
bivdojoavku	metsästysseura
bivdu	pyynti
bivgi	ohra
bivttas	vaate
bivttasgávpi	vaatekauppa
biđggiideapmi	hajonta
biđus	lihakeitto
bižus	kapustarinta
bleahkka	muste
bleahkka	pelti
bliánta	lyijykynä
bliánta	lyijäri
bláđđi	lehti
bláđđi	viikkolehti
boadnji	aviomies
boagán	vyö
boahtal	pullo
boahtimuš	tuleminen
boahtimuš	saapuminen
boahttevuohta	tulevaisuus
boahtteáigi	tulevaisuus
boaimmáš	piekana
boaisán	ryökäle
boaittobealli	syrjäseutu
boaldenmuorra	polttopuu
boaldámuš	polttoaine
boalga	häpeäpilkku
boallooaivi	kullero
boallorássi	kullero
boallu	nappi
boalvár	kauppias
boanda	maanviljelijä
boaran	vanhus
boardda	portaat
boaresbárdni	poikamies
boaresnieida	vanhapiika
boaresnieida	sinkku
boarisvuohta	vanhuus
boarstu	eteinen
boaru	paarma
boassa	hiirenpesä
boasta	posti
boastabiila	postiauto
boastamearka	postimerkki
boasttuvuohta	vääryys
boatkkahas	hyönteinen
boatkun	katkominen
boazoalmmái	poromies
boazobeana	porokoira
boazodilli	porotilanne
boazodoalli	poronhoito
boazodoalloguovlu	paliskunta
boazodoalloguovlu	poronhoitoalue
boazodoallohoavda	poronhoitopäällikkö
boazodoallohálddahus	poronhoitohallinto
boazodoalloláhka	poronhoitolaki
boazodoallopolitihkka	poronhoitopolitiikka
boazodoalloskuvla	poronhoitokoulu
boazodoallostivra	poronhoitojohtokunta
boazodoallošiehtadus	poronhoitosopimus
boazodoallu	poronhoito
boazoeaiggát	poronomistaja
boazoealáhus	poroelinkeino
boazoguohtunlávdegoddi	porolaidunlautakunta
boazoisit	poronomistaja
boazolohku	poroluku
boazolohku	poromäärä
boazoolmmoš	poronhoitaja
boazorikkis	pororikas
boazosápmelaš	porosaamelainen
boazosápmi	porosaamelainen
boazu	poro
boađus	tulos
boađđu	kari
boaššu	posio
boddu	tauko
boddu	vapaatunti
bodni	pohja
bodni	alakerta
bogostat	naurunaihe
bohccejeagil	torvijäkälä
bohccobiergu	poronliha
bohccosuoidni	järvikorte
bohccočoarvi	poronsarvi
bohccádat	putkilo
bohkká	pukki
bohrra	pölinä
bohtal	pullo
boija	poiju
boikohtta	boikotti
boimmohat	nokkimispaikka
boimmon	nokkija
boimmon	näpistelijä
bojá	miekkonen
boksa	säilykepurkki
boksen	nyrkkeily
boldejaš	polttiainen
boles	poliisi
bolot	nappula
bolsttar	patja
bolsttar	tyyny
bomba	pommi
bonjahat	väänne
bonjahat	äkkikäännös
bonus	punos
boradanboddu	ruokatauko
boradanlatnja	ruokahuone
boras	syöpä
borasdávda	syöpä
boraspire	peto
boraspire	petoeläin
boraspirelávdegoddi	petoeläinlautakunta
borešvuohta	mässäily
borga	lumipyry
borgemánnu	elokuu
borgár	kansalainen
borgár	porvari
borgárvuohta	kansalaisuus
borjadat	purjetuuli
borjat	purjetuuli
borjjas	purje
borramuš	ruoka
borramušgávpi	vaatekauppa
borran	ruokailu
borran	syönti
borran	syöminen
borranbeavdi	ruokapöytä
borranboddu	ruokatauko
borranlustu	ruokahalu
borranmiella	ruokahalu
borus	syötävä
boršu	kuohu
bosan	tuuletin
boska	väinönputki
bossu	hetulavalas
botehtos	peruna
botkkon	katkaisin
botkkus	karike
botnjalus	kääntymys
botnus	sakka
bovdehus	kutsu
bovdejupmi	kutsumus
bovden	kutsu
bovdna	mätäs
bovdna	pounu
bovttáš	lunni
boŋkor	pöykkyri
breahtta	tarjotin
breava	kirje
brigáda	prikaati
bronsa	pronssi
brugga	laiturivarasto
brutto	brutto
bruvda	hääkruunu
bruvsa	limsa
bruvsa	limonaati
bráhkka	parakki
buddu	riippa
budjeahtta	budjetti
buffalo	puhveli
buhkka	kakka
buhtadas	korvaus
buhtadus	korvaus
buhtisnieida	neitsyt
buhtisteapmi	puhdistus
buhtástus	puhdistus
buidodat	lihavuus
buksa	housu
buksa	housut
buksalumma	housuntasku
buktu	tuonti
buldu	kirveskalsu
buldugas	korppi
bulet	puolikko
bulgárialaš	bulgarialainen
bulki	pulkka
bulle	sonninmulli
bulljarakkis	kupla
bulljaras	kupla
bullá	pulla
bulži	jääkuori
bumbá	kirstu
bumeránskka	omituisuus
bumma	puomi
bumpaloddi	suopöllö
buncarakkis	ongelma
bunnu	häpykieli
buohccedivššár	sairaanhoitaja
buohcceviessu	sairaala
buohcci	potilas
buohccidikšu	sairaanhoitaja
buohccivuohta	sairaalloisuus
buohccát	sairastaa
buohcu	sairaus
buohcuvuohta	tauti
buohcuvuohta	sairaus
buoidda	kärppä
buoiddat	paksukainen
buoidegaccet	talitintti
buoidi	läski
buoidi	lihava
buoidivuohta	lihavuus
buolaš	kylmyys
buolaš	pakkanen
buolbmágaš	pulmankilainen
buollahat	sytyke
buollin	palo
buolva	polvi
buolva	sukupolvi
buolvadat	sukupolvi
buolát	puola
buolža	poikittaisharju
buonjus	kastike
buorggár	upporikas
buorrevuohta	hyvyys
buorri	hyve
buorráneaddji	toipilas
buorádus	parannus
buoska	pieru
buoska	penska
buoskár	puoskari
buotnjomuš	kastike
buovjja	maitovalas
buovnnjat	myyrä
buozaheaddji	sairaanhoitaja
buozalmasvuohta	tauti
buozan	sairastelija
buođga	nivus
buođus	patoutuma
buresboahtin	tervetuloa
burrodat	hyvyys
burru	sonni
burru	härkä
burrut	sonni
bursa	lompakko
busegáhttu	kissa
busir	pusero
bussa	bussi
busse	bussi
busse	pussi
bussá	kissa
bussá	kisu
bussáealli	kissaeläin
bustávva	kirjain
butká	putka
buvda	kauppa
buvri	aitta
buvri	kömmänä
buvru	puuro
buvssat	housut
buvtta	tuote
buvttadeapmi	tuotanto
buvvedat	tylli
buđaldeaddji	harrastelija
buđet	peruna
buđis	pudas
buđđá	kivespussi
bušeahtta	budjetti
bušeahttarámma	budjettiraami
báberseahkka	paperipussi
bábir	paperi
báddi	naru
báddi	nauha
bádji	paja
bággu	pakko
báhcat	käpy
báhkin	pakana
báhkka	helle
báhkka	kuuma
báhkka	paketti
báhkki	pahka
báhkkon	käsky
báhpagárdin	pappila
báhpaskuvla	rippikoulu
báhppa	pappi
báhtareaddji	pakolainen
báhti	pata
báhtte	patti
báhčinšillju	ampumarata
báhčči	ampuja
báidi	paita
báidnejaš	painajainen
báikegoddi	kylä
báikegoddi	paikkakunta
báikenamma	paikannimi
báikenammaláhka	paikannimilaki
báiki	paikka
báimman	paimen
báinna	värjäysaine
báiski	kalalokki
báiste	paistinpannu
báktedáidda	kivitaide
bákti	kallio
bákŋi	sarventyvi
bálda	vieri
bálddis	pallas
bálggis	polku
bálggosortnet	paliskuntajärjestelmä
bálggus	paliskunta
bálkkašupmi	palkinto
bálká	palkka
bállahastin	heitto
bállahastin	nakkaaminen
bálstá	palsta
bálvalanámmát	palveluammatti
bálvaleaddji	palvelija
bálvaleaddji	palvoja
bálvaleapmi	palvelu
bálvaleapmi	palvonta
bálvalus	palvelu
bálvalusfálaldat	palvelutarjonta
bálvá	palvelija
bámbu	bambu
bánno	pannu
bára	baari
bárbmoloddi	muuttolintu
bárbmu	etelä
bárbmu	parvi
bárdebeaivi	pärttyli
bárdni	poika
bárdnivuohta	poikuus
bárdnivuohta	poikamiesaika
bárel	parila
báron	paroni
bárra	pari
bárra	pariskunta
bárru	aalto
bártnehuoš	poikarukka
bártnáš	poikanen
bárá	para
básmá	pasma
báson	pasuuna
bássa	basso
básta	niini
básár	myyjäiset
bátnedoavttir	hammaslääkäri
bátnesoallun	hammastikku
bátni	hammas
báttas	patoutuma
bávgoš	tylli
bávkkas	pauke
bávččas	kipu
bávččas	kipeä
báŋka	penger
báŋku	pankki
bážáhat	asetuspyssy
bážáhat	ansa
cagan	meriharakka
caggaseapmi	esto
cahkkehus	sytytys
ceagga	itsepäisyys
ceahkki	askel
ceahkkálas	asteikko
cealkka	lause
cealkámuš	lausunto
ciebat	metsäpäästäinen
cielus	haukkumasana
cihca	polttiainen
ciiku	naaraskoira
ciiku	narttu
cirggon	suihkutin
cizopaš	lapinsirkku
cizáš	pikkulintu
coahki	matala
coakci	liukueste
cohcci	houkka
cohkolat	matalikko
cokkaldat	pohjallinen
cubborássi	korte
culpi	hiustupsu
cummá	suukko
cumpi	hiustupsu
cuohppa	kalanliha
cuoppu	sammakko
cuovka	murtoluku
cuoŋománnu	huhtikuu
cuoŋosmánnu	huhtikuu
cuoŋu	hanki
curbmi	suppusuu
curre	kaksonen
cuskkas	tuhina
cára	tsaari
dahkki	tekijä
dahku	teko
dahpahat	ummetus
dahpaldat	tuke
dahppagas	sulkeuma
dajahus	sanonta
dajahus	ilmaisu
dajaldat	sanonta
dajus	lauseke
dallearka	lautanen
darfegoahti	kota
darjjesámegiella	turjansaame
datni	tina
davvi	pohjoinen
davvi	länsi
davviriika	pohjoismaa
davvisámegiella	pohjoissaame
davvisápmi	pohjoissaamelainen
daŋas	varpu
deaddu	paino
deaddu	paine
deaddu	painotus
deadja	tee
deadjabaste	teelusikka
deadjagohppu	teekuppi
deahkki	lihas
deaivvadanbáiki	kohtaamispaikka
deaivvadansadji	tapaamispaikka
deaivvadeapmi	tapaaminen
deajat	tee
dealgi	härkylä
dealljá	grönlanninhylje
deapma	töminä
deappu	levä
dearbastihkka	heiluri
dearbmi	törmä
dearga	törky
dearvvasvuohta	terveys
dearvvašvuohta	terveys
dearvvašvuođabargi	terveydenhuollontyöntekijä
dearvvašvuođabálvalus	terveyspalvelu
dearvvašvuođaguovddáš	terveyskeskus
dearvvuohta	terveys
deatnulaš	tenolainen
deattáldat	jälkiruoka
deattán	painajainen
deavdda	täyte
deavut	halli
deaškkas	lätke
definišuvdna	määritelmä
deklamašuvdna	lausunta
delegašuvdna	valtuuskunta
deminutiiva	deminutiivi
demokratiija	demokratia
departemeanta	ministeriö
departementa	ministeriö
deret	keuhkotauti
derpmoš	törmäpääsky
devdojupmi	täyttymys
diagovva	diakuva
diagrámma	diagrammi
dialeakta	murre
dialoga	vuoropuhelu
dialoga	dialogi
diamehtar	halkaisija
diamánta	timantti
didaktihkka	didaktiikka
diddi	tintti
diddi	titti
didnu	piikivi
diehppi	tupsu
diehppi	liehuke
diehtemeahttunvuohta	tietämättömyys
diehtojuohkin	tiedotus
diehtovuođđu	tietokanta
diehtti	tietäjä
diehtu	tieto
dieigi	harmaakaihi
dieigu	värttinäluu
dienas	ansio
dievasčoahkkin	täysistunto
dievdogahpir	miestenhattu
dievdogákti	miehenkauhti
dievdogákti	miehenkasukka
dievdoolmmoš	mies
dievdu	mies
dieđa	tiede
dieđáhus	tiedote
diftoŋga	diftongi
digaštallan	väittely
digaštallan	keskustelu
diggegoddi	käräjäoikeus
diggi	käräjät
dihkki	täi
dihkku	tikku
dihkku	tulitikku
dihkká	tikka
dihtor	tietokone
dihtorfitnodat	tietokoneyritys
dihtorfitnodat	tietokonefirma
dihtorspeallu	tietokonepeli
dihtorspeallu	tietsikkapeli
diibmobealle	puolitunti
diibmobealli	puolitunti
diibmoplána	aikataulu
diibmoplána	lukujärjestys
diibmu	tunti
diibmu	kello
dikta	runo
diktagirji	runokirja
diktáhtor	diktaattori
diktár	runoilija
dikšu	hoitaja
dikšu	hoito
dikšun	hoito
dikšun	huolto
dildu	hyytelö
dilla	tilli
dilli	olotila
dilli	tila
dilot	sytykehalko
dilálašvuohta	tilaus
dimbbar	tukki
dimenšuvdna	ulottuvuus
dimádas	pehmike
dines	tienesti
dioksiida	dioksidi
direktevra	johtaja
diret	tiirikka
dirči	nakupelle
disdat	tiistai
diskotehka	diskoteekki
diva	korjaustarvike
diva	juoksute
divat	maksu
divat	kymmenys
divišuvdna	liiga
divodus	korjaus
divohat	korjaamo
divri	hyönteinen
divrrasvuohta	kalleus
diđošteaddji	tutkija
diŋga	esine
diŋgojeaddji	tilaaja
diškkanas	roiskahdus
diškkas	roiske
doaba	käsite
doahttu	tutti
doaibma	toimi
doaibmabidju	toimenpide
doaibmadoarjja	toimeentulotuki
doaibmagollu	toimikulu
doaibmaplána	toimintasuunnitelma
doaibmavuohki	toimitapa
doaimmahat	toimisto
doaimmaheaddji	toimittaja
doaimmahus	toimitus
doaivu	usko
doaivu	toivo
doaivva	toivo
doaivvuhisvuohta	toivottomuus
doalli	pitävä
doalli	tenivä
doalloovttadat	toimintayksikkö
doallu	toimintayksikkö
doalut	pidot
doalvu	viejä
doantá	pahus
doardna	torni
doarggástus	järistys
doarggástus	tärinä
doarjalus	tuki
doarjja	tuki
doarjjaortnet	tukijärjestelmä
doarjjaruhta	tukiraha
doavhli	vesirakkula
doavkivuohta	tyhmyys
doavkkan	houkka
doavttergráda	tohtorintutkinto
doavttir	lääkäri
doavttirskuvla	tohtorikoulu
doggi	juoksutusmaha
dohkká	nukke
dohppa	tuppi
dokumeanta	dokumentti
dokumeanta	asiakirja
doleš	meteori
dolgevuogga	perho
dolgi	sulka
dolla	tuli
dollagáddi	tulisija
dollarieban	tulikettu
dopmu	pöly
dordnu	ovi
dorka	turkkipaita
dorski	turska
dorte	rukki
dorve	torvi
dorvu	turva
dovddastus	tunnustus
dovdi	asiantuntija
dovdomearka	tuntomerkki
dovdu	tunne
dovkodat	tyhmyys
dovtta	kuikka
doŋgeribuvssat	farkut
dronnet	kuningatar
drošše	taksi
dubmehus	tuomitseminen
dubmehus	kirous
dudnar	tynnyri
duggu	mälli
duhkaraddi	leikkijä
duhkká	nukke
duhkoraddanskibir	leikkikaveri
duhkoraddi	leikkijä
duhkoras	lelu
duhkoras	leikkikalu
duhkordalˈli	leikkijä
duhpát	tupakka
duhranas	porahdus
duhtavašvuohta	tyytyväisyys
duhtodat	totuus
duiskalaš	saksalainen
dukta	lannoite
dulbodat	tasaisuus
dulka	tulkki
dulkon	tulkinta
dulkon	tulkkaus
dulkonbálvalus	tulkkipalvelu
dullejaš	tuliainen
dulpu	tylppä
dulvi	tulva
dumá	tuuma
duodjegirji	käsityökirja
duodjegávpi	käsityöliike
duodjelatnja	käsityöhuone
duodječájáhus	käsityönäyttely
duodječájáhus	taidenäyttely
duodji	käsityö
duoggi	takku
duogur	leikki
duogáš	tausta
duohpi	huopa
duohpi	vanutus
duohtavuohta	totuus
duohčču	säästö
duojáldat	teelmä
duojár	käsityöläinen
duollji	talja
duollu	tulli
duolmmastat	polkaisu
duolmmastat	poljin
duoltu	tusina
duolvvár	sottapytty
duopma	pohjantuomi
duopmostuollu	tuomioistuin
duopmu	tuomio
duopmár	tuomari
duoraldat	niittaus
duoraldat	poimutus
duorastat	torstai
duorgu	siima
duotka	ruokasula
duottar	tunturi
duottarstohpu	tunturimökki
duottarčielgi	tunturinselkä
duovdda	alue
duođašteaddji	todistaja
duođaštus	todistus
duppalgáibi	kaksoisleuka
durbbon	tarvoin
durji	sottapytty
durján	sottapytty
dusen	tusina
duset	tusina
dutkamuš	tutkiminen
dutkan	tutkiminen
dutkan	tutkimus
dutkan	tutkinto
dutkanbiras	tutkimusalue
dutkandepartemeanta	tutkimusministeriö
dutkandepartementa	tutkimusministeriö
dutkanprográmma	tutkimusohjelma
dutkanprošeakta	tutkimusprojekti
dutkanráđđi	tutkimusneuvosto
dutki	tutkija
dutkán	ripsu
duvdda	tuki
duvdda	rajoitin
duvhllár	tuhlari
duvka	pöytäliina
duvssár	haalija
duđan	kuhnailija
duđan	hössöttäjä
duŋgá	tunkio
dušši	turhuus
dušši	tyhjänpäiväisyys
dáddju	hullu
dádel	taateli
dággi	tahma
dáhkki	katto
dáhkki	takka
dáhkádus	vakuutus
dáhpi	tapa
dáhpáhus	tapahtuma
dáhttu	tahto
dáidda	taide
dáiddaguovddáš	taidekeskus
dáiddamusea	taidemuseo
dáiddačájáhus	taidenäyttely
dáiddár	taitelija
dáidi	taitaja
dáidá	taitaa
dáigi	taikina
dákse	taksi
dáksevuoddji	taksikuski
dákta	tahti
dákti	luu
dálki	sää
dálki	ilma
dálkkas	lääke
dálkkádat	ilmasto
dálkkádatrievdan	ilmastomuutos
dálkunlášmmodahtti	lääkintävoimistelija
dálla	taaleri
dállearka	lautanen
dállu	talo
dálobuoigi	talonpoika
dálolaš	pienmaanviljelijä
dálolaš	talollinen
dálon	talollinen
dálssár	jaarittelija
dálueamit	emäntä
dálueamit	taloemäntä
dálvebivttas	talvivaatteet
dálveguohtumat	talvilaidun
dálveguohtun	talvilaidun
dálvesoahti	talvisota
dálvi	talvi
dáláš	nykyisyys
dámmá	tamma
dámpa	höyrylaiva
dánamánni	kunnianmies
dánsa	tanssi
dánsu	tanssija
dánsun	tanssiminen
dápmot	tammukka
dápmot	purotaimen
dápmu	kesytys
dáppeorru	täälläasuja
dárbbaš	tarve
dárbu	tarve
dárkka	tarke
dárkkistanlávdegoddi	tarkistuskomitea
dárogiella	norja
dárra	levä
dársi	pullukka
dáruiduhttin	norjalaistuminen
dáruiduhttinpolitihkka	norjalaistamispolitiikka
dásageardi	tasakerta
dássi	taso
dássu	laatu
dávda	tauti
dávdi	perna
dávggasvuohta	joustavuus
dávggasvuohta	sitkaus
dávggut	rasitukset
dávllat	täpläkylki
dávttat	väinönputki
dávvir	tavara
dávvir	esine
dávvirvuorká	museo
dávástus	kaiku
dávástus	vastakaiku
dávástus	vastaus
dávástus	vastine
dáčča	norjalainen
dáđđi	tahma
dáški	sotku
dáža	norjalainen
eadnebealle	äitipuoli
eadni	äiti
eadnivuohta	äitiys
eadnivuohta	äidillisyys
eahket	ilta
eahketbeaivi	iltapäivä
eahketbodda	iltatuokio
eahketborramuš	iltaruoka
eahketborramuš	iltapala
eahki	setä
eahpeluohttámuš	epäluottamus
eahppel	omena
eahpádus	epäily
eaiggát	omistaja
eaktu	ehto
ealageardi	käytös
ealet	elukka
ealga	hirvi
ealgabeana	hirvikoira
ealgabivdi	hirvenpyynti
ealgabivdu	hirvenpyynti
ealli	eläin
eallin	elämä
eallindilli	elämäntilanne
eallinoaidnu	elämänkatsomus
eallinvuohki	elämäntapa
eallisilba	elohopea
eallu	poroelo
eallu	elo
eallámuš	elanto
ealáhat	eläke
ealáhat	laidun
ealáhus	elinkeino
ealáhus	elanto
ealáhusdoaibma	elinkeinoelämä
ealáhuspolitihkka	elinkeinopolitiikka
eamit	vaimo
eamit	emäntä
eamiálbmot	alkuperäiskansa
eamiálbmot	alkuperäisasukkaat
eamiálbmotjulggaštus	alkuperäiskansajulistus
eamiálbmotvuoigatvuohta	alkuperäiskansaoikeus
eammi	vaimo
eana	maa
eanadat	maasto
eanadoalli	maanviljelijä
eanadoallu	maanviljely
eanaeaiggát	maanomistaja
eanahálddašeapmi	maanhallinta
eanan	maa
eanandoallu	maatalous
eanandoallu	maanviljely
eananeaiggát	maanomistaja
eananmuorji	mansikka
eananoassi	maanosa
eanavuovdinkantuvra	maanmyyntitoimisto
eanavuovdinláhka	maanmyyntilaki
eanetlohku	enemmistö
eanu	eno
eapmi	emi
eappel	omena
eappir	ämpäri
eappir	pytty
earri	kiintiö
earráneapmi	eroaminen
earta	herne
earuhus	erotus
earuhus	erottaminen
earáhus	muutos
earán	asia
earán	tarve
easka	äsken
eassa	ässä
eastta	este
eatnandoallu	maatalous
eatnandoallu	maanviljely
eatnanmuorji	mansikka
eatnigiella	äidinkieli
eatnu	joki
eavru	hapro
eavttuhus	ehdotus
eaškáleapmi	nyrjähdys
eaškálupmi	nyrjähdys
ebel	omena
ehtemas	juolukka
eiseváldi	viranomaiset
eiseváldi	viranomainen
eissemearka	esimerkki
ekonomiija	talous
eksámen	tentti
elefánta	elefantti
elektrovdna	elektroni
elrávdnji	sähkö
energiija	energia
energiijadepartemeanta	energiaministeriö
erohus	ero
etihkka	etiikka
ettet	etikka
euro	euro
evre	äyri
evttohas	ehdokas
evttohus	ehdotus
eváhkko	evakko
eváŋgiljon	evankeliumi
eŋgel	enkeli
eŋgelasgiella	englanti
fabrihkka	tehdas
fabrihkkabargi	tehdastyöläinen
fabrihkkarátnu	tehdasmatto
faggi	koukku
falleheapmi	hyökkäys
fanas	vene
fanasgoahti	venevaja
fanccis	vene
faskkanas	raape
faskkohat	raape
fastodat	rumuus
feaddi	juurisäie
feaila	virhe
fearahas	veistolastu
fearga	lautta
fearga	väri
fearán	tapahtuma
feaskkir	eteinen
feasku	käsilaukku
feasta	juhla
feasta	bileet
feber	kuume
ferkkon	risukirves
fertenvuohta	täytymys
festivála	festivaali
festivála	festari
fidjol	viulu
fiehta	lapasotka
fielbmá	puro
fiellu	lauta
fierbmi	verkko
fierpmádat	verkosto
fiertu	pouta
fiervá	fieru
fiervábuvri	venevaja
fihkon	viikuna
fihkon	fiikus
fiidnu	halkopino
fiilu	viila
filbma	elokuva
filbma	filmi
filbmadahkki	filmintekijä
filbmafestivála	filmifestivaali
filbmaguovddáš	elokuvakeskus
filttar	kiväärinsuojus
finddar	kampela
finnmárkulaš	finnmarkilainen
finála	finaali
finánsaministtar	talousministeri
firet	nelikko
firkkal	esiliina
fiskescizáš	keltavästäräkki
fiskesdávda	keltatauti
fiskesrássi	idänniittyleinikki
fisku	kalastus
fitnet	saalis
fitnodat	yritys
fitnodat	firma
flágga	lippu
foanda	rahasto
forminddar	holhooja
forum	foorumi
friddjabeaivi	vapaapäivä
friddjaminuhtta	välitunti
friddjavuohta	vapaus
friijaminuhtta	välitunti
frimearka	postimerkki
fuolahusdepartemeanta	sosiaaliministeriö
fuolkevuođanamahus	sukunimitys
fuolkevuođatávval	sukupuu
fuolki	sukulainen
fuolla	huoli
fuomášupmi	huomautus
fuomášupmi	idea
fuorbma	muotti
fuorrávuohta	huoruus
fuotnu	raukka
fuotnu	pahus
fuođar	rehu
fylka	lääni
fylkamánni	maaherra
fylkkadiggi	maakuntakäräjät
fylkkagielda	lääni
fylkkamánni	maaherra
fylkkasuohkan	lääni
fylkkaviessu	läänintalo
fádda	raaka
fáddá	aihe
fága	oppiaine
fágabiras	ammattipiiri
fágalávdegoddi	ammattilautakunta
fágaolmmoš	ammattilainen
fággi	sylipaini
fáhcca	tumppu
fáhkan	miekkavalas
fáippas	huiske
fáksa	faksi
fákta	vahti
fákta	päivystys
fálaldat	tarjous
fális	valas
fálli	jalohaukka
fánen	piru
fánten	pahus
fápmu	voima
fárju	purjekangas
fárppal	tynnyri
fárru	seurue
fárta	vauhti
fárvealla	hyvästit
fástavuorru	vakiovuoro
fástu	paasto
fátmi	syli
fáttar	kummi
fáttar	kuoma
fávre	hyväkäs
fáŋga	vanki
gaccastat	lusikallinen
gaccastat	raapaisu
gaccepaš	lapintiainen
gaccet	talitiainen
gacceš	sorkkanahka
gaccir	niskakuoppa
gahkká	änkyttäjä
gahpir	lakki
gahpir	myssy
gahpárus	sykkyräsuoli
gahtte	kiehkuraishylje
gaiba	lippa
gaibagahpir	lippalakki
gaigŋir	kyynärpää
galba	kilpi
galba	leuka
galbarihcci	kilpikonna
galbmaguolli	pakastekala
galbmagáhkkor	vilukissa
ganjal	kyynel
gapmu	aavistus
garccastat	sitaisu
gardnjil	kyynärpää
garggas	ryöppy
garjá	varis
garra	kuori
garraláibi	näkkileipä
gaska	väli
gaskabeaivi	keskipäivä
gaskabeaivvit	keskipäivä
gaskaidja	keskiyö
gaskaijarock	keskiyörokki
gaskamuddu	puoliväli
gaskan	puolivalmis
gaskasiidu	keskiaukeama
gaskavahkku	keskiviikko
gaskavuohta	suhde
gaskaáigi	keskiaika
gaskkas	kataja
gassaborgi	purka
gassaváhkká	reisilihakset
gassodat	paksuus
gatna	hilse
gavdda	riite
gavja	pöly
gavvaras	kippurakärki
gazza	kynsi
gazzabiza	kynsiajos
gazzaš	sorkkanahka
gaŋgi	köntys
gažaldat	kysymys
geafivuohta	köyhyys
geahpedus	poisto
geahpis	keuhko
geahppamielki	kevytmaito
geahčastat	katse
geahčastat	ilme
geahči	kärki
geahči	pää
geahččaleapmi	kokeilu
geahččaleapmi	koe
geahčči	katsoja
geaidnodoaimmahat	tielaitos
geaidnoguorra	tienpenger
geaidnu	tie
geainnohisvuohta	tiettömyys
geainnohisvuohta	neuvottomuus
gealboguovddáš	kompetenssikeskus
gealddáhat	virike
geallir	kellari
gealva	kaulin
geardeviessu	kerrostalo
geardi	kerta
gearjádus	kerjuu
gearpmaš	käärme
gearra	malja
gearregat	käräjät
gearret	käräjä
gearru	käärö
geasis	kesättivaljaat
geasku	käsky
geassebivttas	kesävaatteet
geasseguohtun	kesälaidun
geasseluopmu	kesäloma
geassemánnu	kesäkuu
geassenávet	kesänavetta
geasseorohat	kesäalue
geassesadji	kesäalue
geassi	kesä
geastegiivvár	kestikievari
geasuheaddji	viehättävä
geasáhat	suonenveto
geatki	ahma
geatnegasvuohta	velvollisuus
geavahanvuoigatvuohta	käyttöoikeus
geavaheaddji	käyttäjä
geavaheapmi	käyttö
geavahus	käyttö
geavla	pikkutakki
geavŋŋis	köngäs
geazaldat	puohde
geađaš	ohimo
geađgenjuorju	kirjohylje
geađgerásttis	kivitasku
geađgi	kivi
geaŧŧu	kehto
gefodat	köyhyys
gelbbolašvuohta	kelpoisuus
gelbbolašvuohta	kompetenssi
gelbbolašvuođaguovddáš	kompetenssikeskus
geres	pulkka
giddagas	vankila
gieddegeašgálgu	tietäjäeukko
gieddegeašáhkku	tietäjäeukko
gieddesuoidni	niittynurmikka
gieddešládja	kenttälaji
gieddi	kenttä
giegacizáš	käenpiika
giegir	henkitorvi
giehka	käki
giehmánni	kauppias
giehpa	noki
giehta	käsi
giehtagávva	käsikynkkä
giehtalávka	käsilaukku
giehtaspábba	käsipallo
giehtačálus	käsikirjoitus
gielda	kunta
gieldagas	kinnerjänne
gieldaviessu	kunnantalo
gieldda	kielto
gielddaplána	kuntasuunnitelma
gielddastivra	kunnanvaltuusto
gielddastivra	kunnanhallitus
gielddasámegiella	kildininsaame
gielddus	kielto
gieldá	kangaskeltalieko
gielis	vale
gielká	kelkka
giella	ansa
giella	kieli
giellabargu	kielityöntekijä
giellabeassi	kielipesä
giellaguovddáš	kielikeskus
giellaguovlu	kielialue
giellagursa	kielikurssi
giellakursa	kielikurssi
giellaláhka	kielilaki
giellalávdegoddi	kielilautakunta
giellanjuolggadus	kielisääntö
giellaprošeakta	kieliprojekti
giellarádjá	kieliraja
giellaráđđi	kielineuvosto
giellastivra	kielijohtokunta
giellavealgu	sinirinta
čuohtegiella	satakieli
čuohtegielaš	satakieli
gielu	verihyytymä
gierdavašvuohta	kärsivällisyys
gierddus	vanneaines
gierdu	vanne
gierdu	ympyrä
gietkka	komsio
gietkka	kätkyt
gieva	suonsilmäke
gievdni	ämpäri
gievdni	kahvipannu
gievkkan	keittiö
gieđahallan	käsittely
gieđalatheargi	käsihärkä
gieđbmi	kattila
gieđbmi	pannu
gieđbmi	sanko
gihcci	eläin
gihli	kihla
gihpa	kansio
giikan	kiikari
giilu	jouhivihvilä
giippár	tynnyrintekijä
giisá	kirstu
giitalus	kiitos
giittos	kiitos
giitu	kiitos
gikta	kyyti
gilisearvi	kyläseura
giliviessu	seuratalo
giliviessu	seurahuone
giljobaš	kiljuhanhi
gilká	tiuku
gilli	kylä
gilljon	kiljuhanhi
gillámuš	kärsimys
gilvaleaddji	kilpailija
gilvu	kilpailu
gilvvohallan	kilpailu
giláš	kylä
ginttal	kynttilä
ginttal	vahakynttilä
girdi	lentokone
girdi	lentäjä
girdišillju	lentokenttä
girdno	kirnu
girdnu	kirnu
girjebusse	kirjabussi
girjegávpi	kirjakauppa
girjehildu	kirjahylly
girjerádju	kirjasto
girjerájus	kirjasto
girječálli	kirjailija
girji	kirja
girji	kirje
girjjálašvuohta	kirjallisuus
girjjáš	kirjanen
girjáivuohta	kirjavuus
girkobáiki	kirkkopaikka
girkodepartemeanta	kirkkoministeriö
girkodepartementa	kirkkoministeriö
girkoeallin	kirkkoelämä
girkogárdi	hautausmaa
girkoráđđi	kirkkoneuvosto
girkosiida	kirkonkylä
girkočoahkkin	kirkkokokous
girku	kirkko
giron	kiiruna
girsa	pukki
gissa	mekastus
gissor	kisura
gistu	ruumisarkku
gitárra	kitara
givgás	kiuas
givlo	kiulu
givssideapmi	kiusaaminen
givssádus	kiusa
givssádus	kiusanhenki
givssádus	kidutus
giđđa	kevät
giđđadálvi	kevättalvi
giđđageassi	suvi
gižaldat	sarana
glássa	ikkuna
goahccevuovdi	havumetsä
goahcci	neulanen
goahki	kuomu
goahtemuorra	ruode
goahtemuorra	kotapuu
goahti	kota
goaigi	uroskärppä
goaigi	hujoppi
goaivu	lapio
goalki	tyyni
goallossátni	yhdyssana
goallu	lamppu
goalsi	pikkukoskelo
goalšu	ruoko
goansta	taide
goargu	sukunimi
goarpa	korppi
goarru	räätäli
goarrunmašiidna	ompelukone
goarrunmášiidna	ompelukone
goarta	kortti
goartil	vartti
goaski	täti
goaskin	kotka
goassige	koskaan
goavdi	katos
goavdi	komo
goaŋku	keitinselkä
goaŧŧu	kohtu
gobbá	kovakuoriainen
gobmi	kummitus
goddesarvvis	villihirvas
goddesáhpán	sopuli
goddi	peura
goddi	villiporo
goddin	tappaminen
goddin	saaminen
gohcci	valvoja
gohpi	kuoppa
gohppa	kuppi
gohppi	lahti
gohppu	kuppi
gohttensadji	leirintäalue
gohttá	leivos
gohttá	viineri
gohči	puukonnysä
gohččun	kutsu
gohččun	käsky
goidoš	vätys
goikebiergu	kuivaliha
goikeguolli	kuivakala
goikket	karvakenkä
goikket	nutukas
goiku	jano
golahus	kulutus
golgadeaddji	kulkuttaja
golggahus	vuodatus
golggotmánnu	lokakuu
golgodávda	kulkutauti
golka	isokulkunen
gollebahta	kiiltokärpänen
gollen	kultasormus
gollerássi	rentukka
gollečeahppi	kultaseppä
golli	kulta
gollu	kulu
golláš	silmäterä
golmmeš	kolmonen
golve	tinauskolvi
gomu	jyrkänne
gonagas	kuningas
gonagasbárdni	prinssi
gonagasnieida	prinsessa
gonagasreabbá	kuningasrapu
gone	koni
gonte	kontti
goppalákču	suursukeltaja
goppás	koppakuoriainen
gordesuoidni	korte
gordni	jyvä
gorostat	ommel
gorostat	ompelulanka
gorsa	kuilu
gorut	raato
gorut	vartalo
gorži	koski
gosahat	yskä
gotka	muurahainen
govdodat	leveys
govva	kuva
govvabláđđi	kuvalehti
govvadáidda	kuvataide
govvagirji	kuvakirja
govvaráidu	sarjakuva
govvaráidu	kuvasarja
govvejeaddji	kuvaaja
govven	kuvaaminen
govččas	peitto
govččas	peite
gođus	kudos
gođus	kudelma
gođán	kudelma
gođđu	kutu
gožu	noki
gráda	aste
grámma	gramma
gráđđa	aste
gubbi	kyssäniska
gudda	hyöty
gudni	kunnia
guhkan	kukkuja
guhkesbearjadat	pitkäperjantai
guhkkodat	pituus
guhkkodatnjuiken	pituushyppy
guhkká	kukka
guhkká	siankärsämö
guhkkár	kukkaro
guhppejeaddji	kuppari
guhppá	kuppaus
guhppár	veripaltto
guhtamáhka	kalansuolimakkara
guigu	hieho
guite	kuitti
guksi	kuksa
guksi	äyskäri
gulahus	kuulutus
gulaskuddan	kuulustelu
gulbmi	silmäkulma
gulca	puukonnysä
guldaleaddji	kuuntelija
gullevašvuohta	kuuluisuus
gulli	kuulija
gulli	kuuntelija
gullu	kuloheinä
gummebáddi	kuminauha
gummestevvel	kumisaapas
gumpe	susi
gumppus	veripaltto
guobaldat	poimutus
guoddi	kantaja
guoddi	vasoja
guoddá	patja
guoddá	tyyny
guoggun	kurkunpää
guohcarássi	suopursu
guohkki	kuokka
guohpa	home
guohttelus	kiila
guohtumat	laidunresurssit
guohtun	laidun
guohtuneanan	laidunalue
guohtunguovlu	laidunalue
guohár	kuohari
guoibmi	puoliso
guoibmi	avopuoliso
guoibmi	kumppani
guoika	koski
guoikgáhrit	koskikara
guoksa	maiti
guolbi	lattia
guolbmá	karvanluonti
guoldu	lumipenkka
guoldu	viima
guolehisvuohta	kalattomuus
guolga	karva
guollebargu	kalastustyö
guollebivdi	kalastaja
guollebivdu	kalastus
guollebivdu	kalastaminen
guollegáhkku	kalapulla
guollejávri	kalajärvi
guollelihkku	kalaonni
guolleoaivi	kalapää
guollerusttet	kalatehdas
guolleskadjá	kalastusvaja
guolleskadjá	venevaja
guolli	kala
guolástanvuoigatvuohta	kalastusoikeus
guolásteaddji	kalastaja
guolásteapmi	kalastus
guolásteapmi	kalastaminen
guolástus	kalastus
guolástusministtar	kalastusministeri
guolástuspolitihkka	kalastuspolitiikka
guopmi	kitalaki
guopmolággá	umpisuoli
guoppar	sieni
guorahallan	selvitys
guorbban	pahanilmanlintu
guorbmi	kuorma
guorbá	pahanilmanlintu
guorga	kurki
guorká	lapamato
guorssahat	köhä
guorti	kasvain
guossa	kuusi
guosselatnja	vierashuone
guossi	vieras
guosttaheavdni	lumikirppu
guotku	kannas
guottu	juurakko
guottádat	hankikanto
guovdajuohku	tasajako
guovddaš	keskus
guovddáš	keskus
guovddáš	keskusta
guovllas	kaulain
guovllupolitihkka	aluepolitiikka
guovllustivra	aluehallitus
guovlodepartemeanta	alueministeriö
guovlodepartementa	alueministeriö
guovloministtar	alueministeri
guovlu	seutu
guovlu	alue
guovludepartemeanta	alueministeriö
guovludepartementa	alueministeriö
guovssahasat	revontuli
guovssat	nieriä
guovssu	koitto
guovttegielalašvuohta	kaksikielisyys
guovttegielatvuohta	kaksikielisyys
guovttos	kaksikko
guovttáš	kakkonen
guovvamánnu	helmikuu
guovža	karhu
guođohanbarta	paimenmökki
guođoheaddji	paimen
guppar	kupari
guret	kurenauha
gurgadas	jono
gurgadas	rivi
gurgadas	säe
gurká	kurkku
gurppastat	niputusnaru
gurra	kuilu
gursa	kurssi
gursalatnja	kurssihuone
gurutbellodat	vasemmistopuolue
guskkádávda	tyrä
gussa	lehmä
gussagoalsi	isokoskelo
gutna	tuhka
guvllár	puoskari
guvtteš	kakkonen
guvžá	meritaimen
guđeš	kuutonen
guškkástat	pikkukuovi
gáddadas	pari
gáddebuvvet	viklo
gáddenjuorju	norppa
gáddi	ranta
gádjit	pikkukajava
gáfeboddu	kahvitauko
gáfeboddu	kahvituokio
gáfehádja	kahvintuoksu
gáfestus	kauhistus
gáfet	kahvi
gáffal	haarukka
gáffe	kahvi
gáffeboddu	kahvitauko
gáffegohppa	kahvikuppi
gáffádat	kahvila
gággá	leili
gáhkkor	kaakkuri
gáhkku	kakku
gáhkká	silmämuna
gáhta	katu
gáhtaearru	katuristeys
gáhtta	katu
gáhttu	katto
gáhttu	kissa
gáhtu	katumus
gáhčči	pihka
gáhčči	valaannahka
gáhčču	kiire
gáibi	leuka
gáibmi	kaima
gáibádus	vaatimus
gáica	vuohi
gáimmežat	kaimakset
gáiru	merilokki
gáisi	vuorenhuippu
gáisá	vuorenhuippu
gáivo	kaivo
gájanas	kaiku
gákci	kahdeksikko
gákkis	sarka
gákkis	kangas
gákti	lapinpuku
gákšu	naarassusi
gákšu	narttu
gála	kahlaamo
gálbbenjunčuonjá	pikkukiljuhanhi
gálbbenjunčuonjá	valkoposkihanhi
gálbi	vasikka
gálbmi	metsähauta
gáldu	lähde
gálggan	kampa
gálgu	vaimo
gálgu	eukko
gállis	aviomies
gállis	ukko
gállis	äijä
gállis	miekkonen
gállot	kallokas
gállu	otsa
gálojeatni	käly
gálvagorddet	peltokorte
gálvu	tavara
gáma	kenkä
gámagoarrun	kengänkudonta
gámme	turvekammi
gámmir	kamari
gámmir	makuuhuone
gámmár	kamari
gámmár	makuuhuone
gánda	poika
gánddaš	poikanen
gánis	ristiluu
gáranas	korppi
gáranasmuorji	riekonmarja
gáranasmuorji	sianpuolukka
gáranasmánnu	huhtikuu
gáranasrássi	ruohokanukka
gárastat	naru
gárastat	siima
gárbmestovla	nojatuoli
gárdi	aitaus
gárdi	poroaita
gárdi	kaarre
gárgolaš	karkulainen
gárgu	rantakivikko
gárta	kartta
gárvu	vaate
gárvu	asu
gárvu	pukimet
gáržžideapmi	rajoitus
gássa	laatikko
gássa	kassa
gássi	termimaito
gássi	korvavaha
gásta	kaste
gásta	kastejuhla
gásttadas	kostuke
gátku	katko
gáttehas	maakrapu
gávas	haukotus
gávcceš	kasi
gávdnjarakkis	suolinkainen
gávgil	kaukalo
gávnnas	nauru
gávnnit	vuodevaatteet
gávnnit	sänkyvaatteet
gávpebargi	myyjä
gávpebargi	virkailija
gávpedepartemeanta	kauppaministeriö
gávpegálvu	kauppatavara
gávpejas	kauppias
gávpi	kauppa
gávpi	liike
gávpot	kaupunki
gávppašanlihppu	kauppalista
gávppašanlistu	kauppalista
gávppašeapmi	kaupanteko
gávppálaš	kauppias
gávstá	kausta
gávttehas	lapinpukuinen
gázzi	seurue
gázzi	perhekunta
gázzi	porukka
gáđffáš	isolumikko
gáđohus	kadotus
gáŋga	kanki
gášan	kailottaja
haddi	hinta
haran	murisija
harcabáddi	hirttoköysi
harcamuorra	hirsipuu
harri	murisija
haŋŋá	alli
headjaskeaŋka	häälahja
heagga	henki
heahki	häkä
heahpu	häpy
heahpu	häveliäisyys
heahtedilli	kriisi
heahteveahkki	ensiapu
heahti	hätä
heaibu	paini
heaidna	hiomakivi
heajastalli	häävieras
heajat	häät
healbmi	helma
heallu	paasi
heallá	paasi
healsa	terveys
hearci	keimailija
heargevuodju	poroajo
heargi	porohärkä
heargi	ajoporo
hearrá	herra
hearrávuohta	herruus
hearta	hertta
heasta	hevonen
heasttahas	hevosmies
heavdni	hämähäkki
heavsmánni	kapteeni
heavuš	hevonen
heavval	höylä
heađálaš	hädänalainen
heaŋgalohkka	riippulukko
heaŋggu	jyrkänne
hehttehus	este
hehttehus	haitta
hehttehus	häiriö
heitojupmi	lakkautus
heiveheapmi	sopeutuminen
hejoš	raukka
helbmo	helmi
helikopter	helikopteri
hellodagat	helluntai
helloduorastat	helluntaipäivä
helloduorastat	helluntaitorstai
helvet	helvetti
heláduorastat	helluntaipäivä
heláduorastat	helluntaitorstai
herkken	härkin
hersko	herkku
hevro	höyry
heđen	sikiö
heđen	hedelmä
heŋge	kieleke
heŋggon	hanko
hieibma	tuulenviri
hieibma	tuulenhenkäys
hihtat	polttiainen
hiistu	veto
hiistu	vedonlyönti
hilbbot	villikko
hilcu	tytönhattara
hildu	hylly
hillaruovssut	tulikettu
hilsku	rikkaruoho
hipmu	himo
hirri	haaru
hirsa	hirsi
historjá	historia
historjá	tarina
historjásearvi	historiaseura
hivsset	vessa
hivvi	hyväkäs
hiđaš	polttiainen
hiŋggal	pilttu
hiŋggal	parsi
hiŋkkas	nyyhkytys
hoagan	hokija
hoahkan	loru
hoahkka	piikkihai
hoahppu	kiire
hoalan	jaarittelija
hoavda	johtaja
hoavrran	mankuja
hoavva	haavi
hoavva	hovi
hoaŋka	hanka
hoašša	korte
holbbis	hulpiokangas
holbi	hulpa
holbi	hulpio
holga	vave
holve	holvi
hommá	homma
homofiila	homofiili
honet	hunaja
horbmá	maitohorsma
hotealla	hotelli
hovdejeaddji	holhooja
hovdejeaddji	vastaava
hubmi	puhuja
huikinjoavku	huutosakki
huikkan	huutaja
huikkanas	huutokerta
huikkas	huuto
huikkas	meteli
huksehus	rakennus
huksen	rakentaminen
huksenlohpi	rakennuslupa
huksenláhka	rakentamislaki
hupma	puheensorina
hupma	humina
hurri	teeri
hábmen	muotoilu
hádja	haju
hága	haka
háhku	aie
háhtta	hattu
háhtádus	kiusankappale
hálbma	olki
hálddahanguovlu	hallintoalue
hálddahus	hallinto
hálddašanguovlu	hallintoalue
hálddašanláhka	hallintolaki
hálddašanorgána	hallintoelin
hálddašanortnet	hallintojärjestelmä
hálddašanovddasvástádus	hallintovastuu
hálddašanplána	hallintosuunnitelma
hálddašeapmi	hallinto
háldi	maahinen
hálgu	halko
hálka	ruokki
hálla	puhe
hállemas	pyhäinpäivä
hálli	puhuja
hálli	puolestapuhuja
hállu	halu
hálvvát	pahus
hámmelheanni	merisaamelaisnainen
hámsson	näykkijä
hánar	kitupiikki
hápman	satama
hápmi	ulkonäkö
hárdu	hartia
hárjehallanbivttas	jumppavaatteet
hárjehallanbivttas	harjoitteluvaatteet
hárjehallanbuvssat	harjoitteluhousut
hárjehallanbuvssat	treenihousut
hárjehallanjáhkka	harjoittelutakki
hárjehallanjáhkka	verryttelytakki
hárjeheaddji	harjoittelija
hárjehus	harjoitus
hárpá	harppu
hárát	harava
háse	haasio
háskil	merikihu
hástalus	haaste
hávda	haahka
hávdda	haude
hávdi	hauta
hávdna	satama
hávga	hauki
hávgarássi	heinävita
hávla	hauli
hávvar	kaura
hávvi	haava
hávvi	kerta
háŋgu	heinähanko
identitehta	identiteetti
idja	yö
idjabivttas	yöpuku
idjaloddi	helmipöllö
idni	pohjankatinlieko
iešdovdu	itsetunto
iešmearridanvuoigatvuohta	itsemääräämisoikeus
iešmearrideapmi	itsemäärääminen
iešstivrejupmi	autonomia
iešvuohta	ominaisuus
iežaskapitála	pääoma
iežáhus	muutos
ihkkon	sontaluukku
ihkkon	ikkuna
ihtalupmi	ihottuma
ihtamas	ihottuma
ildu	hylly
illu	ilo
indiána	intiaani
industriija	teollisuus
informašuvdna	tiedotus
infrastruktuvra	infrastruktuuri
innovašuvdna	innovaatio
instituhtta	laitos
instituhtta	instituutti
institušuvdna	laitos
interneahtta	internetti
interneahttasiidu	nettisivu
internáhtta	sisäoppilaitos
internáhtta	internaatti
investeren	investointi
ipmi	täti
ipmil	jumala
ipmil	jumalatar
ipmilbálvalus	jumalanpalvelus
ipmárdus	ymmärrys
ipmárdus	ymmärtäminen
irgi	poikaystävä
irgi	sulhanen
isit	aviomies
iskan	koe
iskkadeaddji	tiedustelija
iskkadeapmi	tutkimus
iskkus	koe
ivdni	väri
ivguheasta	yykeänhevonen
iđit	aamu
iđitbiebmu	aamupala
iđitbiebmu	aamiainen
iđitgáffe	aamukahvi
jagiáigi	vuodenaika
jahkebealli	puolivuosi
jahkedieđáhus	vuosikertomus
jahkečoahkkin	vuosikokous
jahkečuohti	vuosisata
jahki	vuosi
jallodat	hulluus
jalŋŋis	kanto
jaman	rähisijä
jarfi	pullukka
jargŋa	pullistuma
jaskatvuohta	hiljaisuus
jassa	lumiläiskä
jeaggi	suo
jeagil	jäkälä
jearahallan	haastattelu
jearaldat	kysymys
jearransátni	kysymyssana
jeasta	hiiva
jeatká	jätkä
jeđđehus	lohdutus
jeđđejeaddji	lohduttaja
jiegis	partahylje
jiehkki	jäätikkö
jiehtanas	jättiläinen
jiekta	kihti
jiekŋa	jää
jiella	veto
jielti	punotus
jielti	verirakkula
jienahisvuohta	äänettömyys
jienahisvuohta	käheys
jienahisvuohta	vaitonaisuus
jienasteaddji	äänestäjä
jienasteapmi	äänestys
jierbmi	järki
jietna	ääni
jievjaskuolfi	tunturipöllö
jieŋas	jääsilta
jieŋas	jäätie
jieŋkʼgávli	jääkieleke
joahca	jymy
joatkka	jatke
joatkka	jatko
joatkkaoahpahus	jatkokoulutus
joatkkaoahppu	jatkokoulutus
joatkkaskuvla	lukio
joatkkaskuvla	ammattikoulu
joatkkasoahti	jatkosota
joavdelasvuohta	joutavuus
joavdelasvuohta	joutilaisuus
joavgga	nietos
joavkobargu	ryhmätyö
joavku	ryhmä
jogaš	puro
joggeskuovva	lenkkikenkä
joggeskuovva	lenkkitossu
johka	joki
johkafanas	jokivene
johkagáddi	joenranta
johtalusgalba	liikennemerkki
johtalusčuovga	liikennevalo
johtilvuohta	nopeus
johtilvuohta	kaupattavuus
johtolatčuovga	liikennevalo
johtu	kulkeminen
johtu	liike
johtui	liikkeelle
jokŋa	puolukka
jolla	jolla
jonssot	juhannus
jorbmi	syvänne
jorgaleaddji	kääntäjä
jorgalus	käännös
jorgalus	kääntymys
jorralus	lankeemus
jorri	pyörre
journalista	toimittaja
jođiheaddji	johtaja
jugahus	juotos
jugešvuohta	juoppous
juggi	painanne
jugus	juoma
jugástat	juotava
jugástat	juoma
juhkamuš	juoma
juhkan	juominen
jukca	velli
juksu	kolja
jukta	jodiliuos
julevsámegiella	luulajansaame
julevsápmelaš	luulajansaamelainen
julevsápmi	luulajansaame
julevsápmi	luulajansaamelainen
julevusámegiella	luulajansaame
julggaštus	julistus
julii	heinäkuu
julla	jylinä
julla	jyminä
jumeš	kaksonen
jumešbealli	kaksonen
junii	kesäkuu
juoga	vedenjakaja
juogadeapmi	jakelu
juogus	jaos
juogut	juolukka
juohkin	jako
juohkki	jakaja
juohku	jako
juoigankonsearta	joikukonsertti
juoigi	joikaaja
juoksa	jousi
juolgeluš	jalkopää
juolgesuorbma	varvas
juolgi	jalka
juopmu	niittysuolaheinä
juovka	jouhi
juovlabáhkka	joulupaketti
juovlabáhkka	joululahja
juovlafeasta	joulujuhla
juovlagoarta	joulukortti
juovlakoarta	joulukortti
juovlaluopmu	joululoma
juovlalávlla	joululaulu
juovlamuorra	joulukuusi
juovlamuorra	joulupuu
juovlamánnu	joulukuu
juovlapáhkka	joulupaketti
juovlapáhkka	joululahja
juovlaruohtta	jouluaatto
juovlaskeaŋka	joululahja
juovlastállu	joulupukki
juovlastállu	joulutonttu
juovlačikŋa	joulukoriste
juovllat	joulu
juovva	juova
jurdda	ajatus
jurdda	idea
jurddašanvuohki	ajatustapa
jurista	juristi
jurra	jyrinä
jurssahas	jyrsepala
justiisadepartemeanta	oikeusministeriö
juvla	pyörä
juvla	rengas
juŋgel	viidakko
jábmi	kuoleva
jáffu	jauho
jáffut	jauhot
jáfu	jauho
jáhkka	takki
jáhkku	esitys
jáhti	jata
jálás	jalas
jámeš	haamu
jámeš	vainaja
jámálgaddanvihki	kaatumatauti
jándor	vuorokausi
jánovár	tammikuu
jápmin	kuolema
jápmu	kuolema
járehus	jaaritus
jávkan	poissaolo
jávregáddi	järvenranta
jávri	järvi
kafea	kahvila
kakáo	kaakao
kaleanddar	kalenteri
kandidáhtta	ehdokas
kansliija	kanslia
kantiidna	ruokala
kantiidna	kuppila
kantuvra	toimisto
kanála	kanava
kapihtal	kappale
kapitála	pääoma
karantena	karanteeni
kaseahtta	kasetti
kaseahttačuojanas	kasettisoitin
keailu	vuononhaara
keaisár	keisari
keaksa	keksi
keallir	kellari
kempe	miekkonen
kempe	hienostelija
kievkkan	keittiö
kihtet	kettinki
kihtta	kitti
kiikkár	kiikari
kilo	kilo
kilomehter	kilometri
kino	elokuvateatteri
kioska	kioski
kirku	kirkko
kloasttar	luostari
klubba	klubi
klássa	luokka
klássalatnja	luokkahuone
kneakta	sotamies
knáhppá	kuppa
knállja	nalli
koaffar	matkalaukku
koahkka	kokki
koarra	kuoro
koarta	kortti
kohppa	kuppi
kollektiiva	kollektiivi
kollektiviseren	kollektivisointi
komišuvdna	komissio
kommentára	kommentti
kommišuvdna	komissio
konfereansa	konferenssi
konferánsa	konferenssi
konfirmašuvdna	rippijuhla
konfirmašuvdna	konfirmaatio
konfirmánta	rippiläinen
konklušuvdna	päätelmä
konsearta	konsertti
konsearta	esitys
konsuleanta	konsulentti
konto	tili
kontrákta	sopimus
kontu	tili
konvenšuvdna	konventio
konvenšuvdna	sopimus
kopiija	moniste
kore	kori
korta	kortti
kreakta	suppilo
kreakta	syöpä
kredihttakoarta	luottokortti
kriita	liitu
krisensurbmi	riisiryyni
kristtalašvuohta	kristinusko
krohppa	ruho
krubbá	seimi
kruvdna	kruunu
kruvdno	kruunu
kruvdnu	kruunu
kruvvá	kaivos
krámbuvda	kauppaliike
krámpa	kramppi
krána	nostokurki
kránnjá	naapuri
kráva	kaulus
kubbel	kupoli
kubbel	lampunkupu
kulturbiras	kulttuuripiiri
kulturbálkkašupmi	kulttuuripalkinto
kulturdepartemeanta	kulttuuriministeriö
kulturdoaibma	kulttuuritoiminta
kultureallin	kulttuurielämä
kulturfoanda	kulttuurirahasto
kulturguovddáš	kulttuurikeskus
kulturlávdegoddi	kulttuurilautakunta
kulturministtar	kulttuuriministeri
kulturorganisašuvdna	kulttuurijärjestö
kulturpolitihkka	kulttuuripolitiikka
kulturráđđi	kulttuurineuvosto
kulturskuvla	kulttuurikoulu
kulturulbmil	kulttuuritavoite
kulturvahkku	kulttuuriviikko
kulturviessu	kulttuuritalo
kulturárbi	kulttuuriperinne
kultuvra	kulttuuri
kultuvradepartemeanta	kulttuuriministeriö
kumma	kulho
kunddar	asiakas
kursa	kurssi
kursalatnja	kurssihuone
kurva	kori
kusta	harja
kuvlla	kuula
kuššát	kaulaliina
kvaliteahtta	laatu
kveana	kveeni
kvena	kveeni
kvena	Ruijansuomalainen
kvárta	vartti
kvárta	neljännestunti
káfet	kahvi
káffe	kahvi
kálka	kalkki
kánta	kantti
kántorbargi	toimistotyöntekijä
kántorbargu	toimistotyö
kántorhoavda	osastopäällikkö
kántorveahkki	toimistoapulainen
kárra	karsta
kárta	kartta
kárten	kartoittaminen
kárášjohkalaš	kaarasjokelainen
kássa	laatikko
kássa	kassa
kássahas	kunnanelätti
kátkkesmus	katkismus
kávrret	korppu
ladju	lyijy
lageš	tunturikoivu
lahpis	ihmiskirppu
lahtta	tukkilautta
lahttu	jäsen
laiggasbuđet	lohkoperuna
laksi	kaste
lakta	liitos
lasi	lisää
lasiheapmi	lisäys
lassi	lisä
lassi	lisäys
lassáneapmi	lisäys
lasta	lehti
lastagoahti	lehtikota
lastagoahti	lehtilato
lasáhus	lisäys
latnja	huone
lavdnjegoahti	kota
lavdnji	turve
lađas	nivel
leaggán	notkoselkä
leahki	laakso
leahppi	läppä
leahttu	vauhti
leaibi	leppä
leaika	leikki
leaira	leiri
leaksu	kotityö
leaksu	läksy
leaktu	vauhti
leansman	nimismies
leansmánni	nimismies
leaska	leski
leaska	leskimies
leasmi	reuma
leasmi	reumatauti
leastu	pohjallinen
leatna	lääni
leavga	lippu
leavgabeaivi	liputuspäivä
leavgastággu	lipputanko
leavvedolgi	onnensulka
ledjon	leijona
lesba	lesbo
levlo	löyly
lieggariika	lämminmaa
liehpa	sula
liehppá	rintaläppä
lieksa	riippa
liepma	liemi
lieđđi	kukka
lihkku	onni
lihkohisvuohta	onnettomuus
lihkuhisvuohta	onnettomuus
lihppu	lippu
lihtar	litra
lihtor	peto
lihttebassanmášiidna	astiapesukone
lihttebassanmášiidna	tiskikone
lihtter	litra
lihtti	astia
lihtti	vati
lihttu	liito
liiba	mahdollisuus
liiba	mahis
liibma	liima
liidna	pitkäsiima
liidnegákti	kauhti
liidnegákti	takki
liidnelláš	västäräkki
liidni	liina
liidni	kaulaliina
liigi	liika
liika	ruumis
liikebiktasat	alusvaatteet
liiki	iho
liiru	koppi
liiva	liivi
likta	lyhty
lilljá	lilja
limonáda	limonaadi
linjjá	viiva
linjjá	linja
linjá	viiva
linjá	linja
linjála	viivoitin
linnjá	linja
linnjár	viivain
linádas	pehmike
lista	lista
listaevttohus	listaehdokas
listu	luettelo
listu	lista
liánta	lyijykynä
liánta	lyijäri
liđggastat	vilkaisu
liššá	viikate
loahki	sakka
loahkka	lukko
loahppa	loppu
loahppelákca	kermaviili
loahppemielki	piimä
loahppášbeaivi	loppiaispäivä
loaidu	loito
loaidu	lattia
loamši	rytky
loatna	laina
loavdda	laavukangas
loavku	loukko
loađgu	suopöllö
loađđa	poraamislauta
loddi	lintu
loddu	villakuore
logaldallan	luento
logaldalli	luennoitsija
logeš	kymppi
logijahki	vuosikymmen
logis	kymmenen
logo	logo
logádas	kymmenesosa
lohkamuš	lukeminen
lohkan	lukeminen
lohkanbihttá	lukukappale
lohkangirji	lukukirja
lohkanortnet	lukujärjestys
lohki	lukija
lohkka	lukko
lohkki	kansi
lohku	luku
lohpi	lupa
lohpádus	lupaus
loksa	luotsi
lokta	vintti
lonisteaddji	lunastaja
lonástus	lunastus
lotnji	laskos
lottegazza	linnunvarvas
lovpár	karkulainen
lovssa	luotsi
lubma	tasku
luhkkár	lukkari
luhčadávda	ripuli
luiste	luistin
lulli	etelä
lulli	itä
lullisámegiella	eteläsaame
lullisápmelaš	eteläsaamelainen
lullisápmi	eteläsaamelainen
luládat	etelätuuli
luládat	itätuuli
lumma	tasku
lummor	taskukello
lunta	poika
luodda	jälki
luodda	polku
luoddaearru	tieristeys
luoddaearru	katuristeys
luogga	luokki
luohkká	luokka
luohkká	mäki
luohkkálatnja	luokkahuone
luohti	joiku
luohttevašvuohta	luottamus
luohttámuš	luottamus
luohttámušalmmái	luottamusmies
luohttámušolmmoš	luottamusmies
luoilá	märisijä
luokta	lahti
luokti	katos
luomemeastu	lakkahillo
luomi	lakka
luomi	hilla
luonddugáhttenlihttu	luonnonsuojeluliitto
luonddumeahcci	luonnonpuisto
luondduresursa	luonnonresurssi
luondduriggodat	luonnonresurssi
luondu	luonto
luopmobeaivi	lomapäivä
luopmu	loma
luoppal	lompolo
luossa	lohi
luossabihttá	lohipala
luossabivdi	lohenpyyntö
luossabivdu	lohikalastus
luossagilvu	lohikilpailu
luossajohka	lohijoki
luossaláibi	lohivoileipä
luossanálli	lohityyppi
luossaveajet	lohenpoikanen
luotni	roska
luovvar	apila
luovččan	taltta
luođđa	luoti
lurvu	rätti
lutton	halkoja
lutton	halkaisukirves
luvdá	luuta
luŋká	luukku
lužas	ripuli
lábástat	purjeneula
ládda	panos
ládju	heinätyö
lága	laki
lággu	pyöreäpyrstömolva
lággá	umpisuoli
lággá	letku
lágideaddji	järjestäjä
lágut	heinäkupo
lágádus	kustantamo
láhka	laki
láhka	made
láhkabargu	lakityö
láhkaevttohus	lakiehdotus
láhkalávdegoddi	lakilautakunta
láhkamearrádus	lakipäätös
láhkarievdadus	lakimuutos
láhkateaksta	lakiteksti
láhkaárvalus	lakiehdotus
láhkaásahus	määräys
láhki	tapa
láhki	laatu
láhkka	lakka
láhkkehaš	laes
láhpa	sarventyvi
láhpa	kavennus
láhttenvuohki	käytäntö
láhtterátnu	lattiamatto
láhtti	lattia
láhttu	latu
láhtu	lato
láibbohat	leipomo
láibesuvli	päällyste
láibevajahas	leipäviipale
láibi	leipä
láiddon	laidun
láigi	lanka
láigolaš	vuokralainen
láigu	vuokra
láikkan	laiskuri
láiká	laiskuri
láirá	savi
láittus	moite
lákca	kerma
lákcagáhkku	kermakakku
lákcajiekŋa	jäätelö
lákcajiekŋa	jätski
lámpu	lamppu
lámpá	lamppu
lánnot	lantalainen
lánto	lantti
láppaskas	karitsannahka
láppis	karitsa
lárbma	melu
láse	ikkuna
láse	lasi
lásegárbma	ikkunapieli
láseliidni	verho
láseliidni	verhot
láseráigi	ikkuna
láskkáš	laskiainen
lássa	lasi
lássa	ikkuna
lássaliidni	verho
lássaliidni	verhot
lássalávdi	ikkunapieli
látna	kasa
látna	läjä
láttasadji	maihinnousupaikka
láttat	lakka
láttat	hilla
láttu	lampi
láttu	lätäkkö
lávda	lippu
lávdealmmái	lautamies
lávdegoddi	lautakunta
lávdi	näyttämö
lávdi	lava
lávggohat	kylpylä
lávgungárri	kylpyamme
lávgungárri	amme
lávgunlatnja	kylpyhuone
lávka	laukku
lávkebiffa	sipulipihvi
lávki	askel
lávki	ruokasipuli
lávkkis	kirppu
lávli	nukka
lávlla	laulu
lávllagirji	laulukirja
lávlu	laulaja
lávlu	laulajatar
lávlun	laulaminen
lávlungilvu	laulukilpailu
lávttadas	kostuke
lávttas	kostea
lávttas	kosteus
lávvardat	lauantai
lávvi	ystävä
lávvordat	lauantai
lávvu	laavu
lávži	hihna
lávžá	hevospaarma
láđđegákti	verkapuku
láđđegákti	verkalapintakki
láđđi	verka
lášmmohallan	jumppa
lášmmohallan	liikunta
majonesa	majoneesi
mandáhta	mandaatti
manimuš	munuaiset
manni	menijä
manni	menevä
mannji	miniä
margariidna	margariini
marsipánagáhkku	marsipaanikakku
matematihkka	matematiikka
materiála	materiaali
mađđa	suuntapiirrin
maŋŋebuoidi	peräsuoli
maŋŋebárga	tiistai
maŋŋelgaskabeaivi	iltapäivä
mašiidna	kone
meahcceráđđehus	metsähallitus
meahcci	erämaa
meahcásteapmi	metsästäminen
meahkástat	taivaanvuohi
mealli	mela
mealli	rasvaevä
meannu	käytäntö
mearaguolli	merikala
mearka	merkki
mearkabiire	merkkipiiri
mearkkastat	merkintä
mearkkašupmi	merkitys
mearra	meri
mearrabivdu	kalastus
mearrabivdu	kalastaminen
mearraguolli	merikala
mearraguovlu	merialue
mearragáddi	merenranta
mearragáddi	rannikko
mearraháskil	leveäpyrstökihu
mearrasápmelaš	merisaamelainen
mearrasápmi	merisaame
mearrasápmi	merisaamelainen
mearrebeaivi	määräpäivä
mearri	määrä
mearridanváldi	päätösvalta
mearrádus	määräys
mearrádusevttohus	päätösehdotus
meassu	messu
meassu	juhlat
meattáhus	virhe
meaštár	mestari
media	media
mehter	metri
meren	merisaamelainen
merken	merkintä
metoda	metodi
miehkki	miekka
miehta	hunaja
mieiganstuollu	nojatuoli
mieiggastat	selkänoja
miekta	mätässara
mielddus	liite
mielga	rintalasta
mielki	maito
miella	mieli
miella	tuuli
miellaguoddu	mielipide
miellaguoddu	asenne
miellahttu	jäsen
miellačájáhus	mielenosoitus
mielli	rantatörmä
mielli	jokitörmä
mielli	mäki
mierká	sumu
miessadat	vasannahka
miessemánnu	toukokuu
miesseáldu	vasavaami
miessi	vasa
miestta	pensas
mihcamárat	juhannus
mihkalmas	mikkeli
mihttomearri	tavoite
mihttu	mitta
militeara	sotilas
miljon	miljoona
millu	mylly
minerála	mineraali
minerálaláhka	mineraalilaki
minister	ministeri
ministtar	ministeri
minoritehta	vähemmistö
minoritehtta	vähemmistö
minta	leima
minta	minttu
minuhtta	minuutti
mirkko	myrkky
mirko	myrkky
missu	hera
miššovdna	lähetys
moahtta	ruutimitta
moahtta	syyhy
moaitta	valitus
moalla	maali
moallaolmmái	maalivahti
moarahat	railo
moarsi	tyttöystävä
moarsi	morsian
mobiila	kännykkä
mobiila	matkapuhelin
modealla	malli
modji	hymy
mohkki	mutka
mohtor	moottori
mohtorgielká	lumikelkka
mohtorgielká	skootteri
mohtorsearvi	moottorikerho
moivi	sekasorto
mokta	into
molssaeaktu	vaihtoehto
molssodanlatnja	pukuhuone
molssodanlatnja	pukukoppi
monni	muna
mopeda	mopo
moraš	murhe
moraš	suru
morddár	murhaaja
moriidus	heräys
morči	laskimo
morša	mursu
mođđi	muta
muddu	vaihe
mugga	kannu
muhtter	mutteri
muitalus	kertomus
muiti	muistaja
muitu	muisti
muldi	multa
mulggon	mulkoilija
mullju	sekamelska
muogir	mäkäräinen
muohcu	kirjakoi
muohta	lumi
muohtaáddjá	lumiukko
muohtti	lumipyry
muohtti	lumisää
muohtu	poski
muolda	multa
muolddat	kenttämyyrä
muorjemeastu	hillo
muorji	marja
muorra	puu
muotki	kannas
muotki	muotka
muođut	kasvot
muoŧŧal	sisarenlapsi
muoŧŧá	täti
murdu	tiheikkö
musea	museo
museadoaibma	museotoiminta
museaođastus	museouudistus
musihkar	muusikko
musihkka	musiikki
musihkkafestivála	musiikkifestivaali
musihkkár	muusikko
muttar	kateturve
mutuvra	moottori
muvra	muura
muzet	mustikki
muŋka	munkki
máddi	etelä
máddu	juuri
mádjit	majava
mádjitája	majavapuro
mágoddi	kansanjoukko
máhka	setä
máhka	lanko
máhkka	hietamato
máhku	maku
máhta	ruoka
máhtolašvuohta	kelpoisuus
máhttodepartemeanta	tietoministeriö
máhttu	taito
máhttu	osaaminen
máhttájeaddji	opetuslapsi
mái	toukokuu
máihli	mahla
máilbmi	maailma
máilmmicup	maailmancupi
máilmmisoahti	maailmansota
máinnas	tarina
máinnas	lastentuokio
máistin	maistaminen
máistin	makuaisti
máksu	maksu
máksu	vastike
máksu	kosto
mála	maali
málbma	malmi
málbma	ydinpuu
málesheajat	ruokahäät
máleslihtti	kattila
máleslihtti	ruokailuastia
málesruitu	kattila
málestangursa	ruoanlaittokurssi
málestangursa	ruuanlaittokurssi
mális	keitto
mális	rokka
málle	malli
málli	keitto
málli	rokka
málli	velli
mállásat	päivällinen
málár	maalari
mámmon	mammona
mánnodat	maanantai
mánnu	kuu
mánnu	kuukausi
mánná	lapsi
mánnábiigá	lastenvahti
mánnágeahčči	lastenvahti
mánnávuohta	lapsuus
mánoheahpi	kuutamo
mánáidboddu	lastentunti
mánáidboddu	lastentuokio
mánáidgirji	lastenkirja
mánáidgárdefálaldat	lastentarhatarjonta
mánáidgárdeláhka	lastentarhalaki
mánáidgárdesadji	lastentarhapaikka
mánáidgárdi	lastentarha
mánáidmánná	lapsenlapsi
mánáidruoktu	lastenkoti
mánáidsuodjalus	lastensuojelu
mánáš	lapsonen
márahat	tyrsky
márdu	marto
márfi	makkara
márjjábeaivi	Marianpäivä
márkan	markkina
márkan	kirkonkylä
márkanbáiki	kirkonkylä
márki	markka
mársu	kori
másealgi	vedenjakaja
máska	naamari
mátkeealáhus	matkailuelinkeino
mátkeolmmái	matkaseura
mátki	matka
mátkkošteaddji	matkustaja
mátkkálaš	matkalainen
mátkkálaš	matkustaja
mátta	tyvi
mátta	vartalo
máttabátni	poskihammas
máttarvánhen	esivanhempi
máttaráddjá	isoisoisä
máttaráhkku	isoisoäiti
máttasámegiella	eteläsaame
máttasápmi	eteläsaamelainen
máđir	ahomatara
mášiidna	kone
nagir	uni
nalli	lökäpöksy
namahus	nimitys
namma	nimi
nammaláhpat	nimiloppu
nanni	sisämaa
nannán	manner
narkotihkka	huume
neahku	ulkonäkö
neahti	näätä
neahtta	netti
neahttasiidu	nettisivu
nealgejahki	nälkävuosi
nealggár	ahmatti
nealgi	nälkä
neavttár	näyttelijä
neavva	neuvo
neavva	suositus
nelet	nelikko
niehkki	niska
niehku	uni
niehkulaš	haaveilija
niehtti	pähkinä
nieida	tyttö
nieida	tytär
nieidavuohta	neitsyys
nieidačivga	tyttölapsi
nieidačivga	tyttö
nieiddaš	tyttönen
nierra	poski
nierra	poskipää
niesteboazu	eväsporo
niesti	eväät
nigolaš	unennäkijä
nihlla	hihitys
nihta	uhkaus
niibeboagán	puukkovyö
niibeboagán	veitsivyö
niibi	veitsi
niisa	niisi
niitu	niitty
niski	niska
niskkis	lattiapalkki
nisogordni	vehnäjyvä
nisojáffut	vehnäjauhot
nisoláibi	vehnäleipä
nisoláibi	pulla
nisson	nainen
nissongákti	naistenpuku
nissonjoavku	naisseura
nissonolmmoš	nainen
nissonolmmoš	naisihminen
nisu	nainen
nisu	vaimo
nisu	vehnä
njabadas	palanpainike
njabbi	kenosarvi
njahkanas	nikotus
njalddán	porovaras
njavki	viiste
njavvi	niva
njaŋgaras	rötkäle
njeahcet	saraheinä
njealjejuvlageassi	neliveto
njealjit	nelisoutu
njealjádas	neljännes
njeavdi	lampaannata
njeccon	irvistelijä
njejohat	lakoheinä
njelješ	nelonen
njelot	nelikko
njielastat	nielaisu
njierrá	hiiri
njivdnja	täinmunat
njivli	lima
njivžžanas	lieska
njiŋŋelas	naaras
njiŋŋálas	naaras
njiškun	nauhapirta
njoammelsuoidni	lehtokorte
njoammil	jänis
njoammu	matelija
njoarosteaddji	suopunginheittäjä
njoavdnja	pikkunieriä
njoazan	vitkuttelija
njođahas	sekamelska
njuikehat	hyppyri
njuikestat	hypähdys
njuikkohat	hyppimispaikka
njuikkon	hyppijä
njuikun	hyppy
njukča	joutsen
njukčamánnu	maaliskuu
njunnegeahči	nenänpää
njunni	nenä
njunni	nenäke
njunnádas	keulakuorma
njunuš	kärki
njuohcu	raate
njuolggadus	sääntö
njuolggadus	säädös
njuolla	nuoli
njuolvi	ressukka
njuolvá	ressukka
njuorat	vastasyntynyt
njuorggis	rusto
njuorjjot	hyljekenkä
njuorjju	hylje
njuorju	hylje
njuoskkadas	kostuke
njuovadeapmi	teurastus
njuovahat	teurastamo
njuovvan	teurastus
njuovvanrusttet	teurastamo
njuovvi	teurastaja
njuovčča	kieli
njuozat	vetelys
njurggon	viheltelijä
njuvddán	survoin
njuvvat	hietakampela
njágan	hiiviskelijä
njággu	kenosarvi
njálbmi	suu
njálggeshildu	karkkihylly
njálggis	makeiset
njálggus	karkki
njálggus	makeiset
njálla	naali
njálla	napakettu
njálmmádat	suisto
njámastat	kahmaisu
njárbesoaivi	harvasarvi
njárga	niemi
njávggas	nauˈunta
njášši	allikko
noaidi	šamaani
noarsa	mutu
noarvi	piena
noađđi	taakka
nohkkanlatnja	makuuhuone
nohkkanáigi	nukkumaanmenoaika
norbma	normi
notáhta	muistio
novrrán	koillinen
novrrán	koillistuuli
nođđu	kerä
nulla	nolla
nummar	numero
nummir	numero
nuohtta	melodia
nuohtti	nuotta
nuoraidklubba	nuorisokerho
nuoraidkonferánsa	nuorisokonferenssi
nuoraidlávdegoddi	nuorisolautakunta
nuoraidorganisašuvdna	nuorisojärjestö
nuoraidpolitihkka	nuorisopolitiikka
nuoraidskuvla	yläaste
nuorra	nuori
nuorrabárra	nuoripari
nuorravuohta	nuoruus
nuorri	salmi
nuorta	itä
nuorta	pohjoinen
nuortalaš	koltansaamelainen
nuortalašgiella	koltansaamenkieli
nuortalašgiella	koltankieli
nuortasápmi	itäsaamelainen
nuorti	itä
nuorti	pohjoinen
nuorvu	nuha
nuorvvu	nuha
nuoskkideapmi	saaste
nuovvebáddi	hamppuköysi
nuovvebáddi	hamppunaru
nuppástus	muutos
nurki	kulma
nurrodat	nuoruus
nuvsku	nuuska
nuvttot	nutukas
nággi	näppylä
nággu	riita
náhkkebivttas	nahkavaatteet
náhkkebivttas	nahkavaate
náhkkelaš	nahkavaate
náhkkesoffá	nahkasohva
náhkki	nahka
náhkálaš	nahkaesine
náhppa	poikkikorva
náittosbárra	hääpari
náittosdilli	avioliitto
náittosgovva	hääkuva
náittospárra	hääpari
náittus	häät
náittusvuohta	avioliitto
nákca	kyky
nálas	rotu
nállu	neula
námmʼoaivi	naamasarvi
náránaš	näppy
náskál	naskali
násteboagán	hopeavyö
násti	tähti
nástá	nasta
návdi	susi
návdi	petoeläin
návet	navetta
návetgoahti	navettakota
návetvázzi	karjakko
návetvázzi	lomittaja
návrraš	nauris
návste	venevaja
návstu	venevaja
náđet	jurakko
náššon	kansakunta
oabbá	sisar
oabbá	sisko
oadjebasvuohta	turvallisuus
oaffar	uhri
oaggungilvu	kalastuskilpailu
oahcci	hakija
oahci	rajoitus
oahpaheaddjeoahppu	opettajanopetus
oahpaheaddji	opettaja
oahpahus	opetus
oahpahusguovddáš	opetuskeskus
oahpahusláhka	opetuslaki
oahpahusossodat	opetusosasto
oahpahusráđđi	opetusneuvosto
oahppa	tieto
oahppi	oppilas
oahppofálaldat	opetustarjonta
oahppogirji	oppikirja
oahppolávdegoddi	opintolautakunta
oahpponeavvu	opetusmateriaali
oahppoplána	opetussuunnitelma
oahppostipeanda	opiskelijastipendi
oahppu	oppi
oaidni	näkijä
oaidni	vahti
oaidni	selvänäkijä
oaidnu	mielipide
oainnus	näköala
oaivebávččas	pääkipu
oaivebávččas	migreeni
oaivegávpot	pääkaupunki
oaiveskálžu	pääkallo
oaivi	pää
oaivil	mielipide
oaivvahat	kerä
oaivádat	kalaparvi
oaksi	oksa
oalga	olki
oalgejohka	sivujoki
oalgguhus	yllytys
oalgi	olkapää
oalis	olas
oalul	alaleuka
oamastanvuoigatvuohta	omistusoikeus
oamasteaddji	omistaja
oambealle	serkku
oamedovdu	omatunto
oanádus	lyhenne
oapmahaš	omainen
oapman	uuni
oapmi	omistus
oappáš	pikkusisko
oarbbis	orpo
oarda	orsi
oarjelsámegiella	länsisaame
oarjelsápmi	länsisaamelainen
oarjemáilbmi	länsimaailma
oarji	länsi
oarji	etelä
oarpmealle	tyttöserkku
oarri	orava
oasseprográmma	osaohjelma
oasseváldi	osallistuja
oasseváldi	osaanottaja
oassi	osa
oassálasti	osallistuja
oasti	ostaja
oastin	osto
oastu	ostos
oasus	osake
oasálaš	osallinen
oasálaš	onnekas
oatna	vihi
oaván	urho
oaván	urhea
oađđenlatnja	makuuhuone
oađđinlatnja	makuuhuone
oađđinseahkka	makuupussi
obbalággá	umpisuoli
ofelaš	tiennäyttäjä
ogon	huijari
ohca	povi
ohcamuš	hakemus
ohcan	hakemus
ohcanáigi	hakuaika
ohcci	hakija
oktavuohta	yhteys
olahus	ennätys
olbmoborranrássi	väinönputki
olggobealle	ulkopuoli
olggoš	kansio
olgguldasbivttas	ulkovaatteet
olgofeaskkir	ulkoeteinen
olgoriika	ulkomaa
olgoriikadepartemeanta	ulkoministeriö
olgoriikalaš	ulkomaalainen
olgoseaidni	ulkoseinä
olju	öljy
ollesolmmoš	aikuinen
ollesčoahkkin	täysistunto
olli	ulottuvuus
ollisvuohta	kokonaisuus
olmmoš	ihminen
olmmoš	henkilö
olmmošlohku	asukasluku
olmmošvuohta	inhimillisyys
olmmošvuohta	ihmisyys
olmmošvuoigatvuohta	ihmisoikeus
olmmošvuoigatvuođaláhka	ihmisoikeuslaki
olmmái	ystävä
olmmái	mies
olámuddu	ulottuvuus
omman	uuni
omman	hella
opera	ooppera
opmodat	omaisuus
opmodat	omistus
ordi	särmä
ore	ori
organisašuvdna	järjestö
orgel	urku
orgána	elin
orohat	paliskunta
orohatstivra	aluejohtokunta
orrunlatnja	olohuone
orrunlatnja	tupa
orrunsadji	asuinpaikka
ortnet	järjestys
ortnet	kunto
oskkáldasvuohta	uskollisuus
osku	usko
osku	uskonto
oskál	luottamus
osolaš	osallinen
osolaš	osakas
ossodat	osasto
ovcceš	ysi
ovccádas	yhdeksäsosa
ovdabargu	esityö
ovdagovva	ideaali
ovdagáddu	ennakkoluulo
ovdajuolgi	etujalka
ovdamearka	esimerkki
ovdamunni	etu
ovdanamma	etunimi
ovdanbuktin	esitys
ovdaolmmoš	esimies
ovdaolmmoš	esinainen
ovdaprošeakta	esiprojekti
ovdasaš	etiäinen
ovdaskuvlaoahpaheaddji	esikouluopettaja
ovddastus	edustus
ovddasvástádus	vastuu
ovddasvástádussuorgi	vastuualue
ovddidanbargu	yhteistyö
ovddidanfoanda	kehitysrahasto
ovdu	etu
ovdu	etuus
ovdánahttinbargu	kehitystyö
ovdánanvejolašvuohta	kehitysmahdollisuus
ovdáneapmi	kehitys
ovsttán	itätuuli
ovttadat	yksikkö
ovttamielalašvuohta	yksimielisyys
ovttaoaivilvuohta	yksimielisyys
ovttasbargoguoibmi	yhteistyökumppani
ovttasbargoorgána	yhteistyöelin
ovttasbargoprošeakta	yhteistyöprojekti
ovttasbargovuohki	yhteistyömuoto
ovttasbargošiehtadus	yhteistyösopimus
ovttasbargu	yhteistyö
ovttasorru	avopuoliso
ovttasráđđi	yhteisneuvo
ovtteš	ykkönen
ođas	uutinen
ođasmahtti	uudistuva
ođasmahttin	uudistus
ođastus	uudistus
ođđabeairuohtta	uudenvuodenaatto
ođđabeaivi	uudenvuodenpäivä
ođđajagemánnu	tammikuu
ođđajagimánnu	tammikuu
ođđajagiruohtta	uudenvuodenaatto
ođđajahki	uusivuosi
ođđaássi	uudisasukas
paragráfa	pykälä
parlameanta	parlamentti
pasieanta	potilas
peanna	kynä
penšunista	eläkeläinen
persovdna	henkilö
perspektiiva	näkökulma
pizza	pizza
pizza	pitsa
piáno	piano
plakáhta	juliste
plokka	aura
pláhtta	levy
plána	suunnitelma
plánabargu	suunnittelutyö
plánaeiseváldi	suunnitteluviranomainen
plánaproseassa	suunnitteluprosessi
plánen	suunnittelu
plásttar	laastari
pláŋkosahá	lankkusaha
poasta	posti
poastabiila	postiauto
poastaboksa	postilaatikko
poastamearka	postimerkki
poliisa	poliisi
politihkar	poliitikko
politihkka	politiikka
politihkkár	poliitikko
politiija	poliisi
politiijaguovlu	poliisialue
posišuvdna	asema
potensiála	potentiaali
preassa	lehdistö
preassadieđáhus	lehdistötiedote
preassagovva	lehdistökuva
preassaguovddáš	lehdistökeskus
presideanta	presidentti
prinseassa	prinsessa
prinsihppa	periaate
proavás	rovasti
profehta	profeetta
professor	professori
profiila	profiili
prográmma	ohjelma
projeakta	projekti
proseanta	prosentti
proseassa	prosessi
prosedyra	menetelmä
prostitušuvdna	prostituutio
provsta	rovasti
prošeakta	projekti
prošeaktadoarjja	projektihakemus
prošeaktajođiheaddji	projektijohtaja
prošeaktaruhta	projektiraha
prámá	proomu
pubba	pubi
pulta	pulpetti
pumpa	pumppu
pusse	pussi
páhkka	paketti
pálbma	palmunoksa
pálbmalávvardat	palmulauantai
pálbmalávvordat	palmulauantai
pálbmamuorra	palmupuu
pálbmasotnabeaivi	palmusunnuntai
pánta	pantti
párra	pari
párragoddi	pariskunta
pássa	passi
pássár	harppi
rabasvuohta	avoimuus
raddeleahppi	rintaläppä
raddeleahppi	kauluri
raddi	rinta
radio	radio
rahkadas	aluskasvillisuus
rahppi	avaaja
ramas	luomenreuna
rampi	huithapeli
raporta	raportti
rasisma	rasismi
ravda	reuna
reabbá	rapu
readdju	takki
reahka	reki
reahpenjávri	saivojärvi
reahtta	ruokalaji
reaidnár	poropaimen
reaidu	työkalu
reakci	härmäsieni
reantu	korko
reaská	muikku
reastalas	räystäs
reatká	kataja
reavgganas	röyhtäisy
reavri	länkisääri
reavvi	länkisääri
reaŋga	renki
reašmi	juuriköysi
redaktevra	päätoimittaja
referánsajoavku	referenssiryhmä
regiovdna	alue
registtar	rekisteri
regiuvdna	alue
rehket	lasku
rehketdoallu	tilinpito
reiskáhppi	pyyntiväline
reive	kirje
rektor	rehtori
replihkka	repliikki
restoráŋŋa	ravintola
resursa	resurssi
revolušuvdna	vallankumous
reŋko	palli
ribat	sikolätti
ribon	savipuoli
ridda	ristikko
ridda	säleikkö
riddodepartemeanta	rannikkoministeriö
riddodorski	rannikkoturska
riddoguovlu	rannikkoseutu
riddoministtar	rannikkoministeri
riddu	rannikko
ridnu	kilpa
rieban	kettu
riebangolli	kattikulta
riebansilba	katinkulta
riegádanbeaiskeaŋka	syntymäpäivälahja
riegádanbeaivedearvvuođat	syntymäpäiväterveys
riegádanbeaivi	syntymäpäivä
riegádanmearka	syntymämerkki
riegádeapmi	syntymä
riehkan	työkkyri
riehkki	ajopuu
riehpogállis	repolainen
riehpu	raukka
riehpu	parka
riehtet	vuotakenkä
riehtis	rietas
riehtis	piru
riehtti	vuota
riektavuohta	oikeellisuus
riektedilálašvuohta	oikeussuhde
riektesubjeakta	oikeussubjekti
riekti	oikeus
riestalas	räystäs
rievdadeapmi	muutos
rievdadus	muutos
rievdan	muutos
rievssat	riekko
rievssatbivdu	riekonpyynti
rievssatcizáš	pajulintu
rievssatfálli	tunturihaukka
rievssatmuorji	riekonmarja
rievvu	ryöstö
rievvár	ryöväri
rievvár	rosvo
riffal	rihveli
riggodat	rikkaus
rihca	rääpäle
rihccecuoppu	sammakko
rihcit	sammakko
rihkku	pilkku
rihkkun	pilkku
rihkus	rikos
rihppa	rippi
rihppamánná	rippilapsi
rihppaskuvla	rippikoulu
rihtu	myrsky
rihtu	vyöry
riibmageađgi	riimukivi
riidu	riita
riifu	etana
riifu	harava
riika	valtio
riikarádji	valtionraja
riikkajoavku	maajoukkue
riikkarádji	valtionraja
riikkarádji	riikinraja
riikkarádjá	valtionraja
riikkarádjá	riikinraja
riikkasearvi	maanjärjestö
riikkačoahkkin	maakokous
riipu	etana
riipu	varpekansi
rikkisvuohta	rikkaus
risen	riisi
risenbuvru	riisipuuro
risenrievdna	riisiryyni
risku	risku
risteadni	kummitäti
risttalašvuohta	ristinusko
ristáhčči	kummisetä
risváhnen	kummivanhin
rivgovuolpu	keräpääpoimulehti
riđđu	viima
riđđu	tuuli
riŋga	uuninrengas
riŋggal	rinkeli
rišša	ryöppy
rišša	roiske
riššadoassa	tulitikkuaski
riššasággi	tulitikku
riššu	suihku
roahpi	romu
roahttu	rutto
roaski	roska
roassa	tuulenpuuska
roassu	poropeukalo
roatnet	kapasiika
roavru	komojää
roavskkádat	hankikeli
roavvá	rouva
roašmevihki	spitaali
rock	rokki
rogaš	ruis
roggi	kuoppa
roggi	uoma
roggi	jokilaakso
rohkaláibi	ruisleipä
rohkki	vainaja
rohkkil	höylä
rohkos	rukous
rohpi	katto
rohtu	lehto
rohtu	ryteikkö
roibbon	mutrusuu
rokkahat	kaivanto
rolla	rooli
roman	rumilus
romat	rumilus
romfa	valtti
romána	romaani
ropmivuohta	rumuus
ropmodat	rumuus
rosttot	könkämävuomalainen
rotnu	runo
rovgoš	suokukko
rovvi	silta
rožohat	vatsanväänne
rudda	mauste
rudni	jääkolo
rufanas	hutilus
rufe	ruuhi
ruhci	törky
ruhkku	ruukku
ruhpa	sakka
ruhta	raha
ruhtabursa	lompakko
ruhtadeaddji	rahoittaja
ruhtadeapmi	rahoitus
ruhtadilli	taloustilanne
ruhtadoarjja	rahatuki
ruhtarássi	pikkulaukku
ruhtasubmi	rahasumma
ruigu	ruipelo
ruitu	pata
ruivvan	sottapytty
ruksesjuolčoavžžu	punajalkaviklo
ruksessealgi	punamyyrä
ruksessáhpán	kotihiiri
ruktá	ikkunaruutu
rullit	siankärsämö
rumaš	keho
rumaš	ruumis
rumašlahttu	elin
rumašlahttu	ruumiinosa
rumbu	rumpu
rundierpmis	rasvakala
runčuksu	rasvakala
ruobbi	rupi
ruobboaivi	rupipää
ruohcas	juuri
ruohkahat	raapaisujälki
ruohkastat	raapaisu
ruohtas	juuri
ruohtas	kantasana
ruohtta	aatto
ruoigu	kauris
ruoinnasvuohta	laihuus
ruoivil	hemppo
ruoksi	tuumi
ruoksi	utare
ruoktu	koti
ruomas	susi
ruosku	perse
ruossa	risti
ruossa	risteys
ruossaliidni	ristiliina
ruosta	ruoste
ruotkkuš	juurakko
ruotku	juurakko
ruovdegulmmet	kolmipiikki
ruovdečuolda	ruostesuoni
ruovdi	rauta
ruovttoluodda	takaisin
ruovttubargu	läksy
ruovttubargu	kotitehtävä
ruovttubáiki	kotipaikka
ruovttudoallu	kotitalous
ruovttuguovlu	kotiseutu
ruovttusiidu	kotisivu
ruovttuveahkki	kotiapulainen
ruovttuveahkki	kotiavustaja
ruovttušillju	kotikenttä
ruođat	muikku
ruoššagiella	venäjä
ruoššagáranas	harakka
ruoššanjuorju	grönlanninhylje
ruoššaskire	harakka
ruoššaállat	tunturikiuru
ruoššačuolbma	solmu
ruoŧagiella	ruotsi
ruoŧŧa	ruotsi
ruoŧŧelaš	ruotsalainen
ruoŧŧilaš	ruotsalainen
ruožža	pahus
ruppal	rupla
ruska	roska
ruskalihtti	roskakori
rusta	huuru
rusttet	rakennus
rutiidna	rutiini
ruvdno	kruunu
ruvdnu	kruunu
ruvdorássi	liekovarpio
ruvdu	rahnikko
ruvkedoaibma	kaivostoiminta
ruvki	kaivos
ruŋka	korppi
ruškesvuostá	kutojuusto
ruški	ruska
rušpi	porkkana
ruššu	hutilus
ružžu	rotko
rábbi	haaska
rábbi	raato
rábmot	pröystäillä
rábát	rapakko
ráddi	kekäle
rádjagidden	rajasulku
rádji	raja
rádjá	raja
rádná	kaveri
rádná	toveri
ráfi	rauha
rággi	suikale
ráhkadanneavva	resepti
ráhkaniibi	partaveitsi
ráhkesvuohta	rakkaus
ráhkisvuohta	rakkaus
ráhkku	rakko
ráhpa	rasvakerros
ráhppa	rappu
ráhppa	porras
ráhppá	portaat
ráhppá	rappu
ráhtte	suppilo
ráiddohas	raitomies
ráidi	raitio
ráidodállu	rivitalo
ráidoheargi	raitohärkä
ráidu	raito
ráidu	rivi
ráidá	raita
ráigi	reikä
ráiku	villikko
ráksá	rauhanen
rámbi	rampa
rámburbargi	kaupantyöntekijä
rámburbargi	myyjä
rámbuvra	kauppa
rámbuvri	kauppa
rámbuvri	liike
rámma	kehys
rámmát	raamattu
rámpa	puupino
rámádus	ylistys
ránan	harmo
ránci	sotamies
ránesskuolfi	lapinpöllö
ránnjá	naapuri
rántet	halonhakkuupaikka
rántet	rante
rápma	kehys
rápmi	kehu
rássa	rassi
rássa	rotu
rásselohkku	heinäsirkka
rássi	ruoho
rássi	heinä
rássi	kukka
rásttis	rastas
rátkka	poroerotus
rátnu	raanu
rátnu	matto
ráva	neuvo
rávda	lupikka
rávdi	seppä
rávdnjeheasta	virtahepo
rávdnji	virta
rávdu	nieriä
rávesolmmoš	aikuinen
rávgoš	suokukko
rávisolmmoš	aikuinen
rávrrabihkka	piki
rávvehus	kehotus
rávvehus	neuvonta
ráđđa	aste
ráđđa	rivi
ráđđeaddi	neuvonantaja
ráđđeaddi	neuvoja
ráđđealmmái	kunnanjohtaja
ráđđedagat	sopimus
ráđđehus	hallitus
ráđđejeaddji	hallitsija
ráđđelahttu	neuvostonjäsen
ráđđeolmmái	kunnanjohtaja
ráđđeviessu	kunnantalo
ráđđi	neuvo
ráđđi	neuvosto
ráŋggáštus	rangaistus
sabet	suksi
sadji	paikka
sadji	sija
sadji	tila
sadjásaš	sijainen
sahki	rantahyönteinen
sahpaldat	pölyrätti
sahá	saha
saháreŋko	sahapukki
sainnahat	hinkuyskä
sajus	sijainti
sajádat	asema
sakkis	leikkivene
sakrameanta	sakramentti
salla	syli
sallafággi	sylipaini
sallit	silli
saláhta	salaatti
sarrit	mustikka
sarvvis	hirvas
sarvváskat	hirventalja
sarvádat	hirventalja
savosuotna	selkäjänne
savu	suvanto
savvon	suvanto
saŋáš	syyhy
seahki	sekavuustila
seahki	sekasotku
seahkka	säkki
seahkka	pussi
seaibi	häntä
seaidni	seinä
seaila	sinetti
seaila	sinettivaha
seakkalággá	lynkkysuoli
sealgeeadni	kätilö
sealgi	selkä
sealla	olkain
seamaskas	säämiskä
seamul	sammal
seargge	särki
searvegoddi	seurakunta
searvevuohta	osallisuus
searvi	seura
seavdnjatvuohta	pimeys
seavla	seula
seavli	seula
seavnnját	säynävä
seaŋga	sänky
segelduvka	purjekangas
segohus	sekoitus
segohus	häiriö
sekunda	sekunti
sekšuvdna	osasto
sekšuvdna	sektio
selddetrássi	jouhivihvilä
seminára	seminaari
senet	sinappi
septeamber	syyskuu
servieahtta	servietti
servodat	yhteiskunta
servodateallin	yhteiskuntaelämä
servodatoahppu	yhteiskuntatieto
servodatovdáneapmi	yhteiskuntakehitys
servodatsuorgi	yhteiskuntasektori
sevdnjesáigi	kaamos
sevdnjesáigi	kaamosaika
sevnnjodeapmi	pimennys
sevsa	kastike
seđel	seteli
siehppa	häpykarva
sieidi	seita
siellu	sielu
siepman	siemen
sierrabibliotehka	erikoiskirjasto
sierralohpi	erikoislupa
sierát	siirappi
siessá	täti
sieđga	paju
sieđgaskierri	pohjanpaju
sigareahtta	savuke
signála	signaali
sihkaldat	pyyhe
sihkarvuohta	turvallisuus
sihkastat	pyyhkäisy
sihkkarastin	varmistus
sihkkel	polkupyörä
sihkkel	pyörä
sihkkungumme	pyyhekumi
sihkor	sikuri
sihta	järviruoho
siida	siita
siida	porokylä
siidaguoibmi	naapuri
siidaveahkki	kotiapulainen
siidu	sivu
siiggát	maininki
siilosuoidni	siiloheinä
siivu	keli
silan	ruipelo
silba	hopea
sildi	silta
sildi	silli
silkečuvla	silkkihame
silki	silkki
silli	siivilä
sirdda	siirtymämatka
sirdin	siirto
sirpe	sirppi
sirát	siirappi
sisaboahtu	ansio
sisbuvssat	pikkuhousut
sisbuvssat	alushousut
sisbáidi	aluspaita
sisdoallu	sisältö
siseana	sisämaa
siseanan	sisämaa
sisti	sisna
sivdnideapmi	luominen
sivla	pikkutuulenkala
sivnnát	sinettisormus
sivva	syy
siŋka	sinkki
siŋkanurki	sinkkanurkka
skadjá	venevaja
skavdda	riite
skeahppu	vakka
skeaikkan	räkättäjä
skealbma	veikkuli
skearrogávpi	levykauppa
skearrogávpi	levyliike
skearru	levy
skeaŋka	lahja
skeaŋkár	kenkkäri
skibir	kaveri
skibir	toveri
skiddu	pikkunieriä
skierat	sakset
skierku	verkilö
skierri	vaivaiskoivu
skierru	kiekko
skierru	pikkukajava
skievttár	tuhlaaja
skihpa	sairastelu
skihpár	ystävä
skilan	kilistin
skilan	kellokas
skilanas	kilistin
skilanas	kilahdus
skilkkanas	kilkutin
skilkkanas	kilkahdus
skilla	kilinä
skilleduorastat	kiirastorstai
skillet	killinki
skire	harakka
skoabádat	rahinakeli
skoalpa	norjalaistalonpoika
skoalta	kolttasaamelainen
skoarkil	väkkärä
skoarpa	vaahto
skoarra	pilkkasiipi
skoarri	rääsyläinen
skoavdnji	mörkö
skoavit	pesuvati
skoađđi	kalvo
skohter	lumikelkka
skohtercrossa	kelkkacrossi
skohččebeallji	pystykorva
skoltalaš	kolttasaamelainen
skoret	juottokauha
skorpiovdna	skorpioni
skovvi	lomake
skreaddár	räätäli
skriidna	lipas
skruva	ruuvi
skruvtta	romu
skruvva	ruuvi
skugga	loukko
skuibi	tuohisuppilo
skuibor	tuohilippi
skumpa	läjä
skuogga	hetula
skuoggir	seulaluu
skuoggun	seulaluu
skuohpponjunni	koukkunokka
skuohppu	kotelo
skuohppu	huppu
skuolfi	pöllö
skuordná	pahanilmanlintu
skuordná	surkimus
skuotnja	valonkajo
skuovva	kenkä
skurbbet	keripukki
skuter	lumikelkka
skuvla	koulu
skuvlabeaivi	koulupäivä
skuvladiibmu	koulutunti
skuvlafága	kouluaine
skuvlagirji	koulukirja
skuvlahistorjá	kouluhistoria
skuvlajahki	kouluvuosi
skuvlalatnja	luokkahuone
skuvlamánná	koululapsi
skuvlaseahkka	koulureppu
skuvlaskibir	koulukaveri
skuvlatiibma	koulutunti
skuvlašillju	koulupiha
skuvlejupmi	koulutus
skábe	kaappi
skábma	kaamos
skábma	kaamosaika
skábmamánnu	marraskuu
skádja	kaiku
skáhpi	pihlaja
skáhppa	kaappi
skáhppe	kaappi
skáhppu	laatikko
skáhtta	tapporaha
skáhttu	valkorausku
skáida	kaide
skáida	linkku
skáiti	tunturikihu
skálla	kalina
skálla	kilinä
skálžu	simpukka
skálžžár	leikkisä
skárben	pahus
skárfa	merimetso
skárrit	sakset
skávli	kalalokki
skávžá	viiksi
skáđadivri	tuhoeläin
skážas	sudenkorento
smarfi	kihara
smarvi	kihara
smiergáhttu	para
smirezas	märepala
smirezat	märepala
smuhčči	suppusuu
smáhkka	maku
smáhkkomuorra	hakkuupölkky
smáhkku	tikku
sneaida	pala
sneaida	kaistale
sneaida	maakaistale
snelkkon	näykkijä
snielut	röyhkimys
snihkkár	nikkari
snihkkár	puuseppä
sniiggár	nuukailija
sniiggár	kuokkavieras
snoraldat	kurenauha
snuggamuš	kaluttava
snuhrra	kuorsaus
snuiba	lippa
snuiba	lippalakki
snuoggá	nuuskija
snuohkki	värttinäkoukku
snuolga	räkä
snuolggár	räkänokka
snuolgá	räkänokka
snurkkas	röhkinä
snuvra	nyöri
snuđđor	umpisuoli
snáhki	harus
snáldu	värttinä
snárki	sykkyrä
snárttal	haapana
soabahus	sovitus
soabahus	hyvitys
soabbi	sauva
soabbi	suksisauva
soadji	hiha
soadji	siipi
soadjá	hiha
soadjá	siipi
soaggi	karsta
soagŋu	kosinta
soagŋu	kosiomatka
soahki	koivu
soahpamuš	sopimus
soahti	sota
soairu	luunaskali
soaitin	sattuma
soaittáhat	sattuma
soalddát	sotilas
soallun	hammastikku
soalsi	kuola
soarpa	vaahto
soarvi	kelohonka
soddi	heittonuoli
soddi	vasama
soffá	sohva
sohka	suku
sohkabealle	sukupuoli
sohkabealli	sukupuoli
sohkabuolva	sukupolvi
sohkagoddi	suku
sohkanamma	sukunimi
sohkar	sokeri
sohti	rääsy
soidnár	vitkuttelija
sokta	vaahto
solju	risku
solju	rintakoru
solon	hammastikku
solža	huhupuhe
solža	jaaritus
sosiálabálvalus	sosiaalipalvelu
sotnabeaiskuvla	sunnuntaikoulu
sotnabeaivi	sunnuntai
sovkken	sokea
sovppá	saippua
spahči	tutinasarvi
spanjahas	sälö
spatni	kitakieleke
speadjal	peili
speajal	peili
speajal	varjostin
speallavearka	reunapitsi
speallu	peli
speažži	latuska
spiehkastat	poikkeama
spiella	tuulenvire
spierru	kalaparvi
spihtálaš	spitaalinen
spihtáldávda	spitaali
spihtálvuohta	spitaalisuus
spihčá	piiska
spiidni	sika
spiidni	porsas
spiikkár	naula
spiinnebiergu	sianliha
spiinnebiergu	porsaanliha
spoavár	povari
spábba	pallo
spábbačiekčanjoavku	jalkapalloseura
spábbačiekčanlihttu	jalkapalloliitto
spábbačiekčanšillju	jalkapallokenttä
spábbačiekči	jalkapalloilija
spáiddar	soihtu
spálfu	pääskynen
spálli	tuulenpuuska
spánnja	pytty
spánskkadávda	espanjantauti
spártu	känsä
spártu	nänni
spárvabeaŋka	sorvi
spáđđa	lapio
stahkka	kimpale
standárda	standardi
statistihkka	tilasto
stašuvdna	asema
steaikabánno	paistinpannu
steaikaoapman	paistinuuni
steamma	ääni
steampal	leima
steažžalakkis	sisilisko
stellet	teline
stereo	stereo
stereot	stereot
stevvel	saapas
stielka	ruoti
stipeanda	stipendi
stipeandaortnet	stipendijärjestelmä
stivli	masto
stivra	johtokunta
stivra	hallitus
stivrejeaddji	perämies
stivrejeaddji	kurinpitäjä
stivrenvuohki	ohjaus
stivrrár	komentaja
stoagan	mekastaja
stoagus	lelu
stoahkanapparáhtta	leikkiteline
stoarbma	myrsky
stoavkkan	maiskuttelija
stoavkkas	maiskutus
stobe	purkki
stohpogálvu	huonekalu
stohpu	tupa
stohpu	mökki
stovla	tuoli
stovla	reidet
strategiija	strategia
streaŋga	metallilanka
struhcca	strutsi
struktuvra	rakenne
struktuvra	struktuuri
studeanta	ylioppilas
studio	studio
stuhkka	palanen
stuhkka	kappale
stuibmi	melu
stumpu	pullukka
stuollu	tuoli
stuorasoahttu	auma
stuorradiggeválga	suurkäräjävaalit
stuorradiggi	suurkäräjät
stuorračoavžžu	valkoviklo
sturji	sottapytty
sturrodat	suuruus
stužanas	loiskahdus
stáda	valtio
stádabušeahtta	valtionbudjetti
stádačálli	valtionsihteeri
stáffu	valkama
stággu	onki
stággu	vapa
stáhkkár	raukka
stáhta	valtio
stáhtabušeahtta	valtionbudjetti
stáhtadoarjja	valtiontuki
stáhtaeanan	valtionmaa
stáhtaminister	pääministeri
stáhtaministtar	pääministeri
stáhtaráđđi	ministeri
stáhtačálli	valtionsihteeri
stáhtus	status
stáinnir	merikissa
stálla	talli
stálli	teräs
stállja	talli
stállu	staalo
stáloboska	karhunputki
stálpejahki	petovuosi
stálubursa	tuhkelo
stárrá	ruskolevä
stávru	pitkäkoipi
stávval	tavu
stáđđi	alasin
submi	summa
suddi	sula
suddi	päälakiaukile
suddu	synti
suddu	vahinko
sudja	syy
suhkkol	sukkula
suhpi	haapa
summá	summa
sundi	kihlakunnantuomari
sundi	suntio
suodjalanplána	suojelusuunnitelma
suodjaleapmi	suojelu
suodjalus	suojelu
suodjalusministtar	puolustusministeri
suohkadas	tiheikkö
suohkan	kunta
suohkan	pitäjä
suohkan	naara
suohkanstivra	kunnanvaltuusto
suohkanstivra	kunnanhallitus
suohkančoahkkin	kyläkokous
suohkat	puuro
suohkkobuvssat	sukkahousut
suohkku	sukka
suohkulanmiessi	syysvasa
suohpal	luuta
suohpan	suopunki
suoidnemánnu	heinäkuu
suoidni	heinä
suoivva	varjo
suoivvanas	häilähdys
suola	varas
suolavuohta	varasteluhalu
suolavuohta	varkaus
suoldni	kaste
suoldni	usva
suoldni	halla
suolohas	saarelainen
suolu	saari
suomagiella	suomi
suonjan	pujahtelija
suonjar	säde
suopman	murre
suopman	ääni
suopmelaš	suomalainen
suopmilaš	suomalainen
suorat	haarakeppi
suorbma	sormi
suordna	saarni
suorggahahtti	pelottava
suorgi	haarauma
suorit	haarakeppi
suorpmahat	sormikas
suorpmas	sormus
suorsá	sorsa
suoskangumme	purukumi
suoskangumme	purkka
suoskkahat	purus
suossa	riite
suovasbiergoláibi	savulihavoileipä
suovasbiergu	savuliha
suovdi	kidus
suovdi	kita
suovva	savu
suovvi	heinäsuova
suttoulli	vedenpaisumus
suttuhisvuohta	synnittömyys
suvddá	sooda
suvri	hapanhera
suvri	happo
suvrrus	suurus
suvvol	auder
suvččageapmi	paleltuma
sykkel	polkupyörä
symbola	symboli
systema	järjestelmä
sábel	sapeli
sábin	hiiri
sádjá	tiinu
ságadoalli	puheenjohtaja
ságastallan	keskustelu
ságastallan	vuoropuhelu
ságat	uutiset
ságat	uutinen
sáhka	juttu
sáhka	puhe
sáhka	puheenaihe
sáhka	kerrottava
sáhkavuorru	puheenvuoro
sáhkel	saakeli
sáhkku	sakko
sáhpal	hiirenvirna
sáhppi	sappi
sáhppi	marjamehu
sáhpán	hiiri
sáhttu	kyyti
sáhtán	saatana
sáibbo	saippua
sáibma	kalaverkko
sáibu	saippua
sáidi	seiti
sáidi	sei
sáivačáhceguolli	sisävesikala
sáivačáhci	sisävesi
sáivačáhci	makeavesi
sákta	mehu
sálaš	saalis
sálbma	virsi
sálbmagirji	virsikirja
sálla	sali
sállemuš	sallimus
sálteguolli	sulakala
sálteluossa	suolalohi
sáltemárfi	meetvursti
sálten	suolaus
sálti	suola
sámediggepresideanta	saamelaispresidentti
sámediggeráđđi	saamelaisneuvosto
sámediggi	saamelaiskäräjät
sámeduodji	käsityö
sámegiella	saame
sámekonvenšuvdna	saamelaiskonventio
sámekultuvra	saamelaiskulttuuri
sámeláhka	saamelaislaki
sámeministtar	saameministeri
sámemánná	saamelaislapsi
sámenuorra	saamenuori
sámepolitihkka	saamelaispolitiikka
sámepolitihkkár	saamelaispoliitikko
sámerádio	saameradio
sámesearvi	saamelaisseura
sámeskuvla	saamelaiskoulu
sámevuohta	saamelaisuus
sámeálbmot	saamenkansa
sámeášši	saamelaisasia
sámil	sammal
sámpá	sammas
sánddat	oikeasilmäkampela
sándil	santalo
sápmelaš	saamelainen
sápmelašvuohta	saamelaisuus
sápmi	saamelainen
sápmi	saamenmaa
sápmi	saame
sáppat	saapas
sárahat	suonisäiekimppu
sárdi	kylkiluu
sárdi	kangaskaista
sárdi	maksasuikale
sárdni	saarna
sárdni	puhe
sárdnideaddji	saarnaaja
sárggis	raita
sárri	rönsy
sártnodeapmi	keskustelu
sátku	venevalkama
sátnegirji	sanakirja
sátnelásku	sananlasku
sátnevuorká	sanavarasto
sátnevájas	sananlasku
sátni	sana
sátnja	verkkoresu
sátta	lähetys
sáttagoddi	valtuusto
sáttošloahtta	hiekkalinna
sáttu	hietikko
sávaldat	toive
sávaldat	toivomus
sávdni	sauna
sáve	saavi
sávza	lammas
sávzadoallu	lampaanhoito
sáđgi	nummi
sáŋgár	sankari
sáŋgár	miekkonen
tabealla	taulukko
tableahtta	tabletti
tallearka	lautanen
teadja	tee
teadjabaste	teelusikka
teadjakohppa	teekuppi
teaipa	teippi
teajat	teenlehdet
teajat	tee
teaksta	teksti
teakstaoassi	tekstiosa
tealtá	teltta
tearbma	termi
teknihkkár	teknikko
teknologiija	teknologia
telefonnummir	puhelinnumero
telefovdna	puhelin
telefáksa	telefaksi
televišuvdna	televisio
tema	teema
tempel	temppeli
tente	tentti
teret	keuhkotauti
terminologiija	terminologia
tevnnet	piirustus
teáhter	teatteri
teáhterbihttá	näytelmä
teáhterhoavda	teatteripäällikkö
tieltá	teltta
tiger	tiikeri
tihttel	titteli
tiibma	kello
tiibma	tunti
tiibmaplána	aikataulu
tiibmaplána	lukujärjestys
tiibmu	kello
tiibmu	tunti
tiida	taika
tiida	taikausko
tilla	asianlaita
tinestus	ansiot
tiŋga	esine
toardna	torni
toassa	rasia
toavva	touvi
toga	juna
tohppa	sokeritoppa
tonna	tonni
treagga	harkki
treagga	naara
truvdnu	valtaistuin
tráhppá	portaat
tráhppá	rappu
tráktor	traktori
tuollu	tulli
tuollár	tullimies
turisma	turismi
turista	turisti
turistabivddus	turistipyydys
tuvdni	tunkio
tuvra	retki
táhka	ote
táhka	rupeama
táhkka	kiitos
táhpa	tappio
táksi	taksi
tákta	tahti
tálga	tali
távval	taulu
uddu	haavauma
uddu	arpi
uddu	luukyhmy
udjuvuohta	ujous
uhcagaccaš	pikkuvarvas
uhcamánná	pikkulapsi
uhkki	uhka
uhkku	ukko
uksa	ovi
uksabiellu	ovikello
uksageavja	kahva
uksageavja	ovikahva
ulbmil	tavoite
ulbmil	päämäärä
ulbmiljoavku	tavoiteryhmä
ulbmilparagráfa	tavoitepykälä
ulda	maahinen
ullobáidi	villapusero
ullobáidi	villapaita
ullu	villa
universitehta	yliopisto
unnagaccaš	pikkuvarvas
unnamánná	pikkulapsi
unnaoappáš	pikkusisko
unnavieljaš	pikkuveli
unnitlohkogiella	vähemmistökieli
unnitlohku	vähemmistö
unnitálbmot	vähemmistökansa
upmisámegiella	uumajansaame
upmolcizáš	urpiainen
uradas	tuholainen
urbi	silmu
urbil	urpiainen
uskealla	petkutus
uskealla	ilkivalta
ustit	ystävä
ustitvuohta	ystävyys
uvdna	uuni
uvdna	hella
uvdnu	pajunkissa
uvlu	kimalainen
uvrrus	tasakertahirsi
uđas	lumivyöry
uđas	ryöppy
uštta	uistinsiima
vahkkobeaivi	viikonpäivä
vahkkobláđđi	viikkolehti
vahkkoloahppa	viikonloppu
vahkku	viikko
vahkuloahppa	viikonloppu
vahát	vahinko
vajahas	viipale
valas	merirautu
valástallanhálla	urheiluhalli
valáštallan	urheilu
valáštallanhálla	urheiluhalli
valáštallansearvi	urheiluseura
vanca	vene
varis	koiras
varit	urakka
varra	veri
varrasupmi	verenpurkaus
varračájánas	verinäyte
varris	uros
varáhat	urakantalja
vazadat	vitikeli
vašolaš	vihollinen
vaššu	viima
veadjočuoibmi	koivukanki
veagalváldin	raiskaus
veahkaváldi	väkivalta
veahkkeneavvu	apuneuvo
veahkkeruhta	apuraha
veahkki	apu
veahkki	apulainen
veahkkivuohta	avuliaisuus
veahkkáivuohta	avuliaisuus
veahčir	vasara
veaidni	vamma
veaiggas	kuolemanenne
veaigi	iltahämärä
veaika	lampunsydän
veaja	vastapaino
veajanas	vastapaino
veaksi	evä
veakta	vaaka
veakta	leiviskä
vealaheapmi	sorto
vealahus	syrjintä
vealgi	velka
vealta	valtti
veanzi	vollottaja
veardde	verran
veardi	piipunvarsi
vearju	ase
vearka	särky
vearra	kalastajakylä
vearredahku	rikos
vearri	vääryys
vearri	erehdys
vearrivuohta	vääryys
vearrodahkki	rikollinen
vearru	vero
vearránus	pahennus
vearránus	ärtymys
vearta	arvoinen
veasta	liivit
veattat	liekaporo
veattáhat	vennepaikka
vejolašvuohta	mahdollisuus
venzzon	vollottaja
venzzon	suunvääntäjä
verdde	kaveri
verdde	ystävä
verddeskuvla	ystäväkoulu
verrodat	vääryys
verrát	veräjä
viehkat	vaaka
viehkki	juoksija
vieljaš	pikkuveli
viellja	veli
vielljavuohta	veljeys
vielppis	koiranpentu
viener	viineri
vierca	pässi
viercadat	pässinnahka
vierru	tapa
viessobearráigeahčči	talonmies
viessogálvu	huonekalu
viessohoiddár	talonmies
viessoláigu	vuokra
viessočoavdda	talonavain
viessu	talo
viesttar	länsi
viesttar	länsituuli
vietnansuotna	venymäsuoni
vievssis	ampiainen
vihtan	todistaja
vihttu	vittu
viidni	viina
viisodat	viisaus
viivu	itsehillintä
viivvur	itsehillintä
vilbealle	poikaserkku
vildu	villikko
vilgesoairássi	tupasvilla
vilgesskuolfi	tunturipöllö
vilgesvuostá	juusto
vilpa	kepponen
vinta	kaivonvintti
vintán	järripeippo
virgeolmmoš	virkailija
virgi	virka
visti	rakennus
visti	asunto
vitta	evä
vivva	kummipoika
vivvabealle	vävy
viđadas	viidennes
viđeš	viitonen
viŋkil	suorakulma
višuvdna	visio
vovdna	vaunu
vuhpon	ahmatti
vuoddji	ajaja
vuoddji	uimari
vuoddji	uiva
vuodja	voi
vuodja	rasva
vuodjaláibi	voileipä
vuodjeleaddji	tokanajaja
vuodjin	ajo
vuodjingoarta	ajokortti
vuodjinkoarta	ajokortti
vuodjinlohpi	ajolupa
vuodjinskuvla	ajokoulu
vuogga	viehe
vuogga	onki
vuogádat	järjestelmä
vuohes	vuohinen
vuohki	tapa
vuohppa	appiukko
vuohppa	appi
vuoibmi	voima
vuoiddadus	voitelu
vuoiddas	voide
vuoigatvuohta	oikeus
vuoigatvuođalávdegoddi	oikeuslautakunta
vuoigŋa	henki
vuoiti	voittaja
vuoitu	voitto
vuoitu	palkinto
vuoitu	myyntikate
vuoivvas	maksa
vuoivvasmeastu	maksapasteija
vuoivvasnjuvddus	maksapasteija
vuoivvasoažži	pallea
vuojahat	uittopaikka
vuojaš	jouhisorsa
vuoján	ajoporo
vuoksi	vaaksa
vuoksá	sonni
vuoksá	härkä
vuokta	tukka
vuokta	hius
vuoktafiehta	tukkasotka
vuoktagoalsi	tukkakoskelo
vuoktačuohppi	kampaaja
vuoktašámpu	hiusshampoo
vuoktašámpu	shampoo
vuola	olut
vuolahas	lastu
vuolahas	helve
vuolahat	vuolupaikka
vuolahat	höyläyspaikka
vuolgga	lähtö
vuolildas	alaosa
vuolildusbivttas	alusvaate
vuolla	olut
vuolli	alajuoksu
vuolláibáza	alijäämä
vuolpu	puolihame
vuolpu	leninki
vuoládus	alennus
vuonccis	kana
vuoncáfálli	kanahaukka
vuoncávarris	kukko
vuoni	anoppi
vuonjal	vuongeli
vuoras	vanha
vuoražas	varis
vuoražasmuorji	variksenmarja
vuorbi	arpa
vuorbi	kohtalo
vuorbádus	arvonta
vuordin	lykkäys
vuordámuš	odotus
vuorká	arkisto
vuorká	säilö
vuorkágovva	arkistokuva
vuorru	vuoro
vuortnis	vala
vuoruhansuorgi	satsausalue
vuorčámuorji	variksenmarja
vuorččis	varis
vuoskku	ahven
vuossu	palje
vuossu	palkeet
vuossárga	maanantai
vuosteháhku	vastustus
vuostá	juusto
vuostáláibi	juustovoileipä
vuotna	vuono
vuotnaguovlu	vuonoalue
vuotta	paula
vuovdi	metsä
vuovdin	myynti
vuovssanas	oksennus
vuovssanasdávda	oksennustauti
vuođus	perusta
vuođustus	perusta
vuođđo	perusta
vuođđodoarjja	perustuki
vuođđoealáhus	peruselinkeino
vuođđojurdda	periaate
vuođđoláhka	perustuslaki
vuođđooahpahus	perusopetus
vuođđoskuvla	peruskoulu
vuođđostruktuvra	perusrakenne
vuođđu	perusta
vuođđu	pohja
vuođđudanáššegirji	perustamisasiakirja
vuođđudus	perustaminen
vuođđudus	säätiö
vuoššanruitu	kattila
vuoššanruitu	keittoastia
vuožži	iljanne
váccáhat	jalkakäytävä
váddu	vahinko
vádjolus	vaellus
váffelmávka	vohvelitaikina
vággi	laakso
váhkar	kuopus
váhnen	vanhempi
váhnenčoahkkin	vanhempainkokous
váhpi	lapsivesi
váhttar	vesivaaka
váibbat	vaipukka
váibmogirddáhat	sydämentykytys
váibmosuotna	valtimo
váibmu	sydän
váidalahtti	valitettava
váidalus	valitus
váidda	syytös
váidda	valitus
váidi	ilmiantaja
váidnahádja	kalmanhaju
váikkuhanfápmu	vaikutusvalta
váikkuheapmi	vaikutus
váikkuhus	vaikutus
váilevašvuohta	puute
váili	vaille
váimmus	puuydin
váimmus	atominydin
váipe	hevosloimi
váivi	vaiva
váksi	vaaksa
vákta	vartija
válbor	vappu
váldi	ottaja
váldobargu	päätyö
váldodoaimmaheaddji	päätoimittaja
váldohástalus	päähaaste
váldokantuvra	pääkonttori
váldolávdegoddi	päälautakunta
váldonjuolggadus	pääsääntö
váldooassi	valtaosa
váldosivva	pääsyy
váldoulbmil	päämäärä
váldoášši	pääasia
váldočálli	pääsihteeri
váldošiehtadus	pääsopimus
válga	vaalit
válga	uittosalko
válgabeaivi	vaalipäivä
válgabiire	vaalipiiri
válgaboađus	vaalitulos
válgagižžu	vaalitaistelu
válgajahki	vaalivuosi
válgalávdegoddi	vaalilautakunta
válgaortnet	vaalijärjestelmä
válgastivra	vaalijohtokunta
válgaáigodat	vaalikausi
válli	vala
válljejeaddji	valitsija
válljejeaddji	valitsijamies
válljen	valinta
válsa	valssi
vánddardeaddji	kulkuri
vánddis	päästäinen
vánhen	vanhempi
váran	vadelma
váran	vattu
váravárpá	kurjenkanerva
várjalus	varjelus
várjjagaš	varankilainen
várju	käärinliina
várka	särky
várregilga	vuorenrinne
várrehus	varoitus
várrelahttu	varajäsen
várrepresideanta	varapresidentti
várreáirras	varaedustaja
várri	vaara
várri	vuori
várri	tunturi
vársá	varsa
várta	vartti
várta	neljännestunti
váruhus	varoitus
vásihus	kokemus
vástádus	vastaus
vásáhus	elämys
váttisvuohta	ongelma
vávdno	vaunut
vávvá	nukke
vázzi	kävelijä
vázzin	kävely
vázzingeaidnu	kävelytie
vázzinravda	jalkakäytävä
váđot	mesimarja
váđđu	juksa
váža	porovaadin
Ásia	Aasia
ábiruvvá	merenneito
áddejupmi	ymmärrys
ádden	ymmärrys
áddjut	lapsenlapsi
áddjá	isoisä
áddjá	äijä
ádel	aateli
ágga	anteeksianto
áhkacincu	rasvakala
áhkalakkis	holkeri
áhkalakkis	hai
áhkkilsámegiella	akkalansaame
áhkku	isoäiti
áhkku	akka
áhkkut	lapsenlapsi
áhkkut	lapsenlapsenlapsi
áhkká	vaimo
áhkká	eukko
áhkábiddu	isosimppu
áhpebiegga	merituuli
áhpedovtta	jääkuikka
áhpeguolli	syvänmerenkala
áhpenjuorjju	partahylje
áhpi	meri
áhppa	apina
áhpásmahttojupmi	virvoitus
áhčešeatni	syöjätär
áhčešeatni	kiitäjäinen
áhčči	isä
áibmi	äimä
áibmu	ilma
áiccan	aistin
áiddis	aidas
áidi	aita
áigedávval	aikataulu
áigejorggáldat	päivänseisaus
áigelohku	ajanlasku
áigemearri	aikamäärä
áigečála	aikakauslehti
áigga	aikomus
áiggegollu	ajankulu
áiggeádji	harrastus
áiggeájáhus	ajanviete
áigi	aika
áigodat	ajanjakso
áigumuš	aikominen
áigumuš	tahto
áigáiboahtu	toimeentulo
áimmuhisvuohta	ilmattomuus
áinnuhaš	ainokainen
áinnut	ainokainen
áirras	edustaja
áiru	airo
áiti	aitta
áitta	uhka
ája	lähde
ájanas	ajanviete
ájasámil	vesisammal
ájáhus	viivytys
ájáhus	ajatus
ákkilveaksi	rintaevä
ákta	näytös
ákšodearri	kirveenterä
ákšonađđa	kirvesvarsi
ákšoskuohppu	kirveentuppi
ákšu	kirves
álbmot	kansa
álbmotallaskuvla	kansankorkeakoulu
álbmotbeaivi	kansallispäivä
álbmotjoavku	kansakunta
álbmotkatastrofa	kansankatastrofi
álbmotlašvuohta	kansallisuus
álbmotmeahcci	kansallispuisto
álbmotriekti	kansanoikeus
álbmotskuvla	kansakoulu
álbmotčoahkkin	kansankokous
álddagas	salama
álddis	allas
áldodat	vaatimennahka
áldu	vaadin
álgga	aloite
álggahus	aloitus
álggahus	johdanto
álgodálvi	alkutalvi
álgoálbmot	alkuperäiskansa
álgoálbmotjulggaštus	alkuperäiskansajulistus
álgoálbmotvuoigatvuohta	alkuperäiskansaoikeus
álgu	alku
álkivuohta	helppous
állan	kyynärä
állat	pulmunen
áltár	alttari
álvi	ahjo
álvu	saalis
ámadadju	kasvot
ámmát	ammatti
ámtamánni	maaherra
ánsikta	kasvot
ánsu	ansio
ánuheaddji	anoja
áppes	aapinen
áppet	ape
ápril	huhtikuu
ára	tulisija
ára	tulenpesä
árbbolaš	perillinen
árbediehtu	perinnetieto
árbeguođđi	perinnönjättäjä
árbejeaddji	perijä
árbevierru	perinne
árbevierru	traditio
árbi	perintö
árbmu	armo
árbmugasvuohta	armeliaisuus
árga	arki
árgabeaivi	arkipäivä
árgabivttas	arkivaatteet
árgabivttas	arkivaate
árggan	arkajalka
árja	energia
árka	paperiarkki
árpmuattáldat	armolahja
árpu	lanka
árran	tulisija
árran	tulenpesä
árvalanguoibmi	neuvottelukumppani
árvalus	arvio
árvosátni	arvosana
árvu	arvo
árvvoštallan	arviointi
árvvoštallan	päätelmä
árvvoštallan	arvostelu
árvádus	arvoitus
ásaheaddji	asettaja
ásaheaddji	perustaja
ásahus	asetus
ásahus	laitos
ásahus	instituutio
ásen	aasi
ásii	asia
ásodat	asunto
ássanbáiki	asuinpaikka
ássanguovlu	asuinalue
ássansadji	asuinpaikka
ássi	asukas
ássu	rauha
ástageađgi	talkkikivi
ástmá	astma
ávaštus	aavistus
ávdugasvuohta	autuus
ávgos	elokuu
áviisa	lehti
áviisa	sanomalehti
ávji	heinä
ávjjur	kuplahylje
ávjoruovdi	teräase
ávki	hyöty
ávnnas	aine
ávssis	akseli
ávvudeapmi	juhliminen
ávžžuhus	kehotus
áššebábir	asiapaperi
áššedovdi	asiantuntija
áššedovdilávdegoddi	asiantuntijalautakunta
áššelistu	asialista
áššemeannudeapmi	asiankäsittely
ášši	asia
áššu	hiillos
áŧestus	ahdistus
Čáhcesuolu	Vesisaari
čahras	räkätys
čakča	syys
čakča	syksy
čakčadálvi	myöhäissyksy
čakčageassi	syyskesä
čakčaluopmu	syysloma
čakčamánnu	syyskuu
čalbmeguolga	silmäripsi
čalbmelásat	silmälasit
čalbmeláset	silmälasit
čalbmi	silmä
čanas	side
čanus	sidos
čarkkus	vesipääsky
časkinbárru	iskuaalto
čađaheapmi	kokemus
čađaheapmi	läpikäynti
čađan	lävistäjä
čađđa	hiili
čeabet	kaula
čeabetliidni	kaulahuivi
čeabetliidni	huivi
čeabetnávdi	sieppuri
čeabi	kaula
čeabát	kaula
čeagŋi	matalajalka
čeahborgi	puolipurka
čeahci	setä
čeahppivuohta	taitavuus
čeaksa	satakerta
čearda	laji
čearddalašvuohta	etnisyys
čeargga	kinos
čeargganas	karjaisu
čeargganas	ukkosenjyrähdys
čearggas	karjunta
čearpmahat	kermikäntalja
čearpmat	vasa
čearret	tiira
čearrit	lapintiira
čeavllit	ylpeilijä
čeavrris	saukko
čeŋkkeš	pikkusormi
čeŋkkeš	pikkuvarvas
čibbi	polvi
čiegusvuohta	salaisuus
čiehka	kulma
čiehča	seiska
čiekka	luunsiru
čiekčansihkkel	potkupyörä
čiekči	jalkapallopelaaja
čiekči	jalkapalloilija
čiekŋalas	syvänne
čielggadeapmi	selvitystyö
čielggadus	selitys
čielggadus	selvennys
čielggadus	selvitys
čielggus	orsi
čielgi	selkä
čielkkis	riskilä
čieran	lumilauta
čieras	itku
čierastallan	mäenlasku
čierastallanluohkká	laskettelumäki
čierrá	itkupilli
čievččastat	potku
čihkalas	finni
čihtta	kitti
čiksa	tavi
čikŋa	koriste
čikŋa	koru
čikŋabivttas	juhlavaatteet
čilgehus	selitys
čilli	pullukka
čitnun	ummetustauti
čivga	pentu
čivrrus	täinmunat
čižeš	seiska
čižži	rinta
čoaggi	poimija
čoahkkebáiki	taajama
čoahkkin	kokous
čoahkkingirji	kokouskirja
čoahkkinjođihangoddi	kokousjohtokunta
čoahkkinortnet	päiväjärjestys
čoahkkáigeassu	yhteenveto
čoahkádus	koostumus
čoakkádus	koostumus
čoakkán	kokous
čoalas	ripuli
čoalli	suoli
čoarvebaste	sarvilusikka
čoarveduodji	luukäsityö
čoarveniibi	luupuukko
čoarvenjunni	sarvikuono
čoarvi	sarvi
čoarvvus	sarvet
čoaskkadas	jäähdyke
čoavdda	avain
čoavddus	ratkaisu
čoavjebávččas	mahakipu
čoavjebávččas	vatsakipu
čoavjedávda	vatsatauti
čoavjemuorra	vatsapuu
čoavji	vatsa
čoavji	maha
čoavžžu	viklo
čoađgi	telkkä
čogu	kampa
čohkkehus	koostumus
čohkun	kampa
čolga	sylki
čora	parttio
čora	porotokka
čorbma	nyrkki
čorgejeaddji	siivooja
čotta	kurkku
čottaboalddáhat	kurkkutulehdus
čottabávččas	kurkkutauti
čottanjálggis	pastilli
čovdojupmi	ratkaisu
čovdojupmi	päätös
čujuhus	osoite
čujuhus	viite
čukčá	ukkometso
čuogus	latkittava
čuogus	liemi
čuohtejahki	vuosisata
čuoibmi	sauvoin
čuoigan	hiihtokilpailu
čuoigan	hiihto
čuoiganbeaivi	hiihtopäivä
čuoiganbuvssat	hiihtohousut
čuoigi	hiihtäjä
čuoika	hyttynen
čuoika	sääski
čuojanas	soitin
čuokkis	piste
čuolahat	hakkuupaikka
čuolahat	pilke
čuolbma	solmu
čuolddasmuorra	venytyskeppi
čuolus	veistos
čuonan	kipinä
čuonjá	hanhi
čuopma	kalannahka
čuopmajas	pohjanvariksenmarja
čuorpmas	jäärae
čuorpmas	rae
čuorvvas	huuto
čuossi	sarvenvälinahka
čuovga	valo
čuovgadas	kirkkaus
čuovgagovva	diakuva
čuovgagovva	valokuva
čuovggahisvuohta	sokeus
čuovus	liite
čuovvu	seuraaja
čuovža	siika
čuozáhat	kohde
čuočča	loimi
čuoččuhus	väite
čuođádas	sadasosa
čurti	pylly
čuru	kärpänen
čurvestat	huudahdus
čurvestat	iskusana
čuvdi	etusormi
čuvku	juustomassa
čuvla	hame
čuvla	leninki
čužot	etusormi
čábbe	kaunokainen
čábbodat	kauneus
čáhceloddi	sorsa
čáhceruvven	vesihieronta
čáhcerávga	vesihiisi
čáhcerávga	vetehinen
čáhci	vesi
čáhppesmuorji	variksenmarja
čáihni	pisama
čájus	näytös
čájáhallan	esittely
čájáhallan	näytteleminen
čájáhalli	näyttelijä
čájáhat	näyttämö
čájáhus	esittely
čájáhus	näyttely
čájálmas	näyttely
čájánas	näyte
čála	kirjoitus
čálastat	viilto
čálgu	viihtyvyys
čálgu	hyvinvointi
čáliheapmi	ilmoittautuminen
čálli	kirjailija
čálli	sihteeri
čállin	kirjoittaminen
čállingirji	kirjoitusvihko
čállingoddi	sihteeristö
čállingursa	kirjoittamiskurssi
čállingursa	kirjoituskurssi
čállinkursa	kirjoituskurssi
čállinkursa	kirjoittamiskurssi
čállinvuohki	kirjoitustapa
čállu	kirjoitus
čálus	kirjelmä
čálus	luonnos
čámbokkal	ripsiäinen
čámsa	taimen
čáppagirjjálašvuohta	kaunokirjallisuus
čárvá	koura
čárvá	ote
čátná	taulakääpä
čávgŋi	parsi
čáza	vety
čázadat	sadeilma
čázet	nahkakenkä
čázádat	vesistö
šaddanbeaivi	syntymäpäivä
šaddu	kasvi
šaddu	hedelmä
šakŋa	sää
šakŋa	keli
šaldi	silta
šattalmas	kasvain
šearfa	kaulaliina
šearpa	valtaus
šibit	kotieläin
šibitdoallu	eläinpito
šibitdoallu	eläinhoito
šibitdoavttir	eläinlääkäri
šibitdállu	karjatalo
šiehtadallan	neuvottelu
šiehtadus	sopimus
šielbmá	kynnys
šieđđa	läähätys
šikkas	ärähtely
šikkas	hätistys
šillju	piha
šilta	kyltti
šimir	hamara
širra	ryöppy
širrá	vesikirppu
širrá	punkki
šlahtti	räntä
šleahtta	rantamatala
šleaivi	kömpelö
šleanci	lerppa
šleađđu	tasanko
šleaŋgu	linko
šliipá	tahko
šliita	raadanta
šlimpá	heiluri
šlivggas	helmanheilutus
šliŋgu	linko
šloahtta	linna
šlubbu	sorkkamätä
šlubbá	sorkkamätä
šluŋki	luppakorva
šládja	laji
šlákta	teuras
šlákta	teurastus
šláttar	juoru
šláva	orja
šnjierrá	hiiri
šnjirggas	kirkuna
šnjirggas	kirskuna
šnjirggas	hirnunta
šnjoarra	lirinä
šoalkaliidni	ristiliina
šoalkaliidni	silkkiliina
šoaláhat	rankkasade
šoaŋki	ruipelo
šokčá	jäniksenansa
šombbár	sössöttäjä
šuddi	hälinä
šuhkoláda	suklaa
šuhkoládagáhkku	suklaakakku
šuhkoláde	suklaa
šukkuláda	suklaa
šuodjá	paholainen
šuohkanas	huokaus
šuohkas	huokailu
šuokŋa	sävel
šuorja	jättiläishai
šuovka	jouhi
šuvva	kohina
šuvva	suhina
šuđgá	hätähousu
šállja	raita
šállo	sääli
šámpu	shampoo
šávge	tarmonpesä
šávká	lakki
atnubiktasat	arkivaatteet
atnubiktasat	pitovaatteet
birrasat	lähiympäristö
brillat	silmälasit
dánsejaččat	tanssiaiset
gálojenežat	kälykset
hirssat	hirssi
lávežat	ystävykset
riemut	juhlat
ristejaččat	ristiäiset
ráhkkásaččat	rakastavaiset
siktajáffut	sihtijauhot
silát	silavaljaat
skieryt	kärryt
skihpáraš	kaverukset
suittet	suitset
ustibaččat	ystävykset
vuoigŋašat	aivot
čuožžunčuovggat	seisontavalot
lihkkolohku	onnenluku
jienastuslohku	äänestysluku
johtolat	liikenne
hárjehallan	harjoitus
leansmánnekantuvra	nimesmiestoimisto
ohcanáigemearri	hakuaika
juoigan	joikaaminen
bodda	tuokio
bázahus	jäänne
jahkebealle	puolivuosi
ohcanskovvi	hakulomake
stuorradiggeáirras	kansanedustaja
opposišuvdna	oppositio
gaskkamuddu	puoliväli
mohtorfievru	moottoriajoneuvo
olgobáiki	ulkopaikka
ráđđádallan	neuvottelu
bárti	onnettomuus
dovdda	tunne
čuojaheaddji	muusikko
čuojaheaddji	soittaja
jury	valamiehistö
presideantaevttohas	presidenttiehdokas
lotnolasealáhus	elinkeinoyhdistelmä
birasgáhttenossodat	ympäristösuojeluyksikkö
stivrejupmi	johtomuoto
boazopolitiija	poropoliisi
giđđalodden	sorsametsästys
valáštalli	valmentaja
virgelohpi	virkaloma
oasáš	osanen
olggosgollu	kulu
suhttu	suuttumus
luossagonagas	lohikuningas
dálkkodeapmi	käsittely
fokus	fokus
giellaruhta	kieliraha
našunálateáhter	kansallisteatteri
mobiilatelefovdna	kännykkä
eahpesihkarvuohta	epävarmuus
agronoma	agronomi
preassadoarjja	lehdistötuki
ealáhussearvi	elinkeinoseura
teknihkka	tekniikka
našuvdna	kansakunta
sirkus	sirkus
Bissojohka	Pyssyjoki
miellahttuvuohta	jäsenyys
romantihkka	romantiikka
klinihkka	kliniikka
beannot	puolitoista
galle	montako
golbma	kolme
guhtta	kuusi
guokte	kaksi
gávcci	kahdeksan
logi	kymmenen
moadde	muutama
máŋga	moni
máŋga	monta
njeallje	neljä
okta	yksi
ovcci	yhdeksän
vihtta	viisi
čieža	seitsemän
čuođi	sata
duhát	tuhat
gákcilogi	kahdeksankymmentä
čiehččalogi	seitsemänkymmentä
čuohti	sata
miljárda	miljardi
miljovdna	miljoona
ammal	juo
goit	kuitenkin
goit	ainakin
goittotge	kuitenkin
goittotge	ainakin
mis	tosiaan
na	no
no	no
nuba	niinpä
nai	myös
ala	päälle
alde	päällä
alde	päältä
aldi	päällä
aldi	päältä
badjel	yli
badjelis	yllä
badjelis	päällä
bajábealde	yläpuolella
bakte	kautta
beal	puoli
bealde	puolella
bealde	puolelta
bealdi	puolella
bealdi	puolelta
beales	puolella
beali	puoli
bealis	puolella
beallai	puolelle
birra	ympärillä
birra	ympäriltä
bokte	kautta
bokti	kautta
bálddas	vieressä
bálddas	vierestä
báldii	viereen
dihte	takia
dihtii	vuoksi
duohken	takana
duohken	takaa
duohkái	taakse
ektui	ehdolla
fárus	mukana
gaskii	väliin
gaskka	kesken
gaskkas	välissä
gaskkas	välistä
geahčai	luo
geahčai	luokse
geahčai	kotiin
geahčen	luona
geahčen	kotona
geahčen	luota
geahčen	kotoa
geažes	kuluttua
geažil	vuoksi
gorrái	suhteen
guhku	pituinen
guoras	äärellä
guoras	ääreltä
guoras	ääressä
guoras	äärestä
guovdu	keskellä
gurrii	ääreen
gurrii	laitaan
guvlui	suhteen
haga	ilman
hahttá	ilman
lahka	lähellä
losu	painoinen
luhtte	luona
luhtte	luota
luhtti	luona
luhtti	luota
lusa	luokse
ládje	tavalla
láhkai	tavalla
maŋis	perässä
maŋis	perästä
maŋábealde	takana
maŋábealdi	takana
maŋŋel	jälkeen
maŋŋil	jälkeen
maŋŋá	jälkeen
maŋŋái	perään
miehtá	pitkin
mielas	mielestä
mielde	mukana
mielde	mukaan
oaidnut	nähden
olggobealde	ulkopuolella
olggobealdi	ulkopuolella
olis	mukaan
ovddas	edessä
ovddas	edestä
ovdii	eteen
rastá	poikki
rádjái	asti
sadjái	sijaan
sajis	sijassa
sajis	sijalla
sisa	sisään
sisa	sisälle
siskkobealde	sisäpuolella
siste	sisällä
siste	sisältä
sisti	sisällä
viiddu	laajuinen
vulobealde	alapuolella
vuolde	alla
vuolde	alta
vuolis	enteenä
vuollel	alla
vuollái	alle
vuostá	vastaan
vuođul	perusteella
várte	varten
várás	takia
čađa	läpi
čieŋu	syvyinen
badjel	yli
birra	ympäri
birra	ympärillä
maŋŋá	jälkeen
ovdal	ennen
ovdal	aikaisemmin
guovdelaš	keskellä
earret	paitsi
dakkár	sellainen
dakkáraš	sellainen
diet	se
dot	tuo
duokkáraš	tuollainen
duot	tuo
dákkár	tällainen
dát	tämä
buohkat	kaikki
buot	kaikki
eará	muu
eará	eri
eará	muuta
goabbat	kumpikin
guktot	molemmat
iešguđet	itsekukin
iežá	muut
juoga	jokin
juoga	jotakin
juohke	joka
juohke	jokainen
juoidá	jotakin
makkárge	minkäänlainen
maidege	mitään
mihkkige	mikään
moanat	useat
muhtun	joku
olus	juurikaan
olus	paljonkaan
seamma	sama
seammá	samoin
váháš	vähän
mihkkege	mitään
guhtege	jokainen
goabbáge	kumpikin
muhtin	muutama
diekkár	tällainen
soames	muutama
goappašat	molemmat
iešguhtet	jokainen
juohkehaš	jokainen
goappaš	molemmat
gii	kuka
goabbá	kumpi
makkár	millainen
makkár	minkälainen
makkáraš	millainen
makkáraš	minkälainen
mii	mikä
giige	kukaan
giige	kukin
guhtet	kukin
juobbá	jompikumpi
juobbágoabbá	jompikumpi
juohkehaš	jokainen
miijai	mikin
dat	se
dat	hän
dii	te
don	sinä
mii	me
mun	minä
sii	he
soai	he
son	hän
ieš	itse
gii	kuka
guhte	kuka
guhte	joka
mii	mikä
addit	antaa
ale	älä
almmuhit	ilmoittaa
astat	ehtiä
astat	joutaa
atnit	käyttää
badjánit	kohota
bahčit	lypsää
bargat	työskennellä
bargat	tehdä
bargat	pyrkiä
barggahit	teettää
basadit	peseytyä
basadit	peseskellä
bassaladdat	pestä
bassat	pestä
bassit	paistaa
batnit	kehrätä
bealkit	haukkua
bearráigeahččat	tarkistaa
besset	pesiä
beassat	päästä
beastit	pelastaa
beroštit	välittää
berret	pitää
bidjat	laittaa
bidjat	panna
bieggat	puhaltaa
bieguhit	kiusata
biehttalit	kieltää
biehttalit	pettää
biggohit	tuulettaa
bilidit	pilata
billahuvvat	pilaantua
billašuvvat	pilaantua
billistit	pilata
birget	pärjätä
bissut	jäädä
bistit	kestää
bisánit	pysähtyä
bivaldit	lämmetä
bivastuvvat	hikoilla
bivdit	pyytää
bivvat	tareta
biđget	rikkoa
biđget	hajottaa
biškut	kirkua
boagustit	nauraa
boahtit	tulla
boaldit	polttaa
boatkkuhit	hiekottaa
boatkuluvvat	kipeytyä
bohčit	lypsää
boradit	aterioida
boradit	syödä
borahit	syöttää
bordit	kasata
borgat	pyryttää
borgguhit	polttaa
borrat	syödä
borvet	pöyhiä
borvet	penkoa
bossut	puhaltaa
botnit	kehriä
botnit	kehrätä
botnjat	vääntää
bovdet	kutsua
bovdet	pyytää
bovret	porata
buktit	tuoda
bumpet	pumpata
buohcat	sairastaa
buollit	palaa
buoridit	parantaa
buorránaddat	hyväillä
buorránit	parantua
buorástahttit	tervehtiä
buođđut	padota
buressivdnidit	siunata
báhcit	jäädä
báhkket	pakata
báhkket	paketoida
báhtarit	paeta
báhčit	ampua
báidnit	värjätä
báitit	kiiltää
báitit	paistaa
bálkestit	heittää
bálkestit	viskata
bárgut	parkua
bárgut	huutaa
bávkalit	paukauttaa
bávkit	paukkua
bávččagit	sattua
bávččastit	sattua
caggat	estää
caggat	kiristää
cahkkehallat	sytytellä
cahkkehit	sytyttää
ceaggát	törröttää
cealkit	lausua
cegget	pystyttää
ciellat	haukkua
cieládit	haukahtaa
coakcut	pitää
coggat	sujauttaa
coggat	pukea
coggat	tunkea
cuovkanit	murskaantua
cábadit	silputa
dadjat	sanoa
dahkat	tehdä
deaddit	painaa
deaivat	tavata
deaivat	kohdata
deaivat	osua
deaivat	sattua
deaivvadit	tavata
dearvvahit	tervehtiä
dearvvašmuvvat	tervehtiä
dearvvašnuvvat	tervehtiä
deavdit	täyttää
dekoreret	koristella
diehtit	tietää
dievvat	täyttyä
dieđihit	tiedottaa
dihttot	ilmetä
dihttot	näyttäytyä
diktit	sallia
dikšut	hoitaa
dinet	ansaita
divuhit	korjauttaa
divvut	korjata
diŋgot	tilata
diđoštit	tiedustaa
doadjit	katkea
doahput	tarttua
doaibmat	toimia
doaimmahit	toimittaa
doaivut	toivoa
doalvut	tuoda
doalvut	viedä
doamihit	kiirehtiä
doapmalit	kiirehtiä
doapmat	kiirehtiä
doapmat	kiiruhtaa
doarggistit	täristä
doarggistit	väristä
doarjut	tukea
doarrut	tapella
doaškut	taputtaa
dohkkehit	hyväksyä
dohkket	kelvata
dohppestit	napata
dohppet	napata
dohppet	siepata
doidit	huuhtoa
dolastaddat	tulistella
dolastallat	tulistella
dolkat	kyllästyä
dollet	suunnata
dovdat	tuntea
duddjot	ommella
duhtat	tyytyä
dulkot	tulkata
dulkot	kääntää
dulvadit	padota
duogŋat	paikata
duoldat	kiehua
duolddahit	keittää
duolddahit	kiehuttaa
duostat	uskaltautua
duostat	uskaltaa
duskidit	tuskailla
dutkat	tutkia
dádjut	värkätä
dáhpáhuvvat	tapahtua
dáhttut	tahtoa
dáhttut	pyytää
dáidit	taitaa
dálludit	talostella
dálludit	asua
dálostallat	asua
dánsestit	tanssahtaa
dánset	tanssia
dánsut	tanssia
dápmat	kesyttää
dárbbahit	tarvita
dárbbašit	tarvita
dárkilit	tarkasti
dáŋket	tankata
eaidat	etääntyä
ealihit	elättää
eallit	elää
ealáskahttit	elvyttää
earránit	erota
eattehit	suuttua
evttohit	ehdottaa
fallehit	hyökätä
falástallat	urheilla
faláštallat	urheilla
ferdnet	jauhoa
fertet	täytyä
fidnet	saada
figgat	yrittää
figgat	pyrkiä
fillet	juksata
fillet	huijata
firtet	seljetä
fiskkodit	kellastua
fitnat	käydä
fuobmát	huomata
fáippastit	huitaista
fállat	tarjota
fárret	muuttaa
fáruhit	varoa
gahččat	putoa
gahččat	pudota
gaikkehit	nykäistä
gaikut	kiskoa
gaikut	repiä
gaivát	tuijottaa
galbmot	paleltua
galbmot	kylmetä
galgat	täytyä
galgat	pitää
galledit	vierailla
gallestallat	vierailla
galljut	pyöristyä
gallánit	täyttyä
galmmihit	kylmettää
galmmihit	jäädyttää
galmmihit	pakastaa
garahit	kuoria
garvilit	välttää
garvit	kiertää
geahkat	vihjata
geahčastit	vilkaista
geahččalit	kokeilla
geahččat	katsoa
geahččat	katsella
geallat	kiillottaa
geardduhit	kerrata
geargat	keretä
geassit	vetää
geasuhit	houkutella
geasástit	valjastaa
geavahit	käyttää
geiget	ojentaa
giddet	sulkea
gielistit	valehdella
gierdat	kestää
gieđahallat	käsitellä
giitit	kiittää
giksat	kypsyä
gillet	jaksaa
gillet	viitsiä
gillát	kärsiä
gilvalit	kilpailla
gilvit	kylvätä
gilvvohallat	kilpailla
girdit	lentää
givssidit	kiusata
goaivut	kaivaa
goallut	palella
goardit	paistaa
goargŋut	nousta
goaridit	kurjistaa
goaridit	haitata
goarrut	ommella
goddit	tappaa
gohcit	valvoa
gohčodit	kutsua
gohčodit	nimittää
gohččut	käskeä
goikadit	kuivattaa
goikadit	paistaa
goikat	kuivua
goikat	kuivata
gokčat	peittää
gokčat	sulkea
golgat	valua
golgat	vuotaa
golket	tyyntyä
gollat	kulua
gopmánit	ylösalaisin
gossat	yskiä
govvet	valokuvata
gođđat	kutoa
gođđit	kutoa
gulahallat	keskustella
gulahallat	ymmärtää
guldalit	kuunnella
gullat	kuulla
gullot	kuulua
guoddit	kantaa
guoddit	synnyttää
guorahaddat	tutkia
guorahallat	tutkia
guorranit	tyhjentyä
guovlalit	vilkaista
guovlalit	kurkistaa
guovlat	kurkata
guovlat	kurkistaa
guovllastit	katsella
guođohit	paimentaa
guođđit	jättää
gurput	kantaa
gurret	tyhjentää
gáddit	luulla
gádjut	pelastaa
gáibidit	vaatia
gálašit	kahlailla
gánnáhit	kannattaa
gárrat	sitoa
gártat	koitua
gártat	joutua
gártat	päätyä
gárvodit	pukeutua
gáržudit	rajoittaa
gáržudit	supistaa
gáržudit	kaventaa
gáskit	purra
gáskkestit	puraista
gásttašit	kastaa
gávdnat	löytää
gávdnot	löytyä
gávppahit	kaupitella
haksit	haista
haksot	haista
heahtáduddat	hätäillä
heaitit	lakata
heavahit	kaataa
heavvanit	hukkua
heaŋgát	riippua
heivehit	sovittaa
heivet	sopia
hervet	koristaa
hervet	koristella
heŋget	riippua
himihit	rykäistä
himihit	rykiä
hoavrristit	hourata
hoavrristit	hourailla
hoavrristit	maasata
hoavrristit	jankuta
hohkahit	houkutella
hoigat	työntää
huhttát	kyyröttää
huhttát	kököttää
huikit	huutaa
huikkádit	huudahtaa
hukset	rakentaa
humadit	jutella
hupmat	puhua
huraidit	hyräillä
huškut	lyödä
huškut	iskeä
háhkat	hankkia
háleštit	jutella
háliidit	haluta
hállat	puhua
hárdit	kiusata
hárjehallat	harjoitella
hárjánit	tottua
hástalit	haastaa
hávdádit	haudata
háŋket	hankkia
idjadit	yöpyä
ihtit	ilmestyä
ihtit	tulla
ihtit	näkyä
ii	ei
ijastallat	yöpyä
illudahttit	ilahduttaa
illudit	ilahtua
imaštallat	ihmetellä
ipmirdit	ymmärtää
iskat	koettaa
iskat	tutkia
iskkadit	kokeilla
iskkadit	koetella
ivdnet	värittää
iđit	aamu
jaskkodit	hiljetä
jearahallat	kysellä
jearahit	kysellä
jearralit	kysellä
jearrat	kysyä
jeđđet	lohduttaa
jienádit	äännähtää
jietnadit	äännellä
jietnadit	ääntää
jietnadit	äännähtää
joatkit	jatkaa
joavdat	ehättää
joavdat	saapua
johtalit	kulkea
johtit	matkustaa
johtit	lähteä
joksat	saavuttaa
joradit	pyöriskellä
jorgalit	kääntää
jorggihit	kääntyä
jorrat	hyrrätä
jorrat	pyöriä
jođašit	kulkea
jođašit	kuljeskella
jođašit	liikkua
juhkat	juoda
juohkit	jakaa
juoigat	joikata
jurddahit	ajatella
jurddašit	ajatella
jáddadit	sammuttaa
jáhkkit	uskoa
jápmit	kuolla
jávkat	kadota
jávkat	hävitä
jávkkihit	livahtaa
lahkanit	lähestyä
lahkonit	lähestyä
lasihit	lisätä
leabbut	levitellä
leahkastit	aukaista
leahkastit	avata
leaikkastallat	pilailla
leaikut	kaataa
leat	olla
leavvat	levitä
lebbet	levittää
leiket	kaataa
libardit	lepattaa
libardit	liehua
liegganit	lämmetä
liekkadit	lämmittää
ligget	lämmittää
lihkadit	liikkua
lihkkat	herätä
liikot	pitää
liikot	tykätä
liktet	silottaa
livvadit	maata
loahpahit	lopeta
loaktit	kuluttaa
loaktit	viihtyä
logadit	lukea
logadit	lueskella
lohkat	lukea
lohkat	laskea
lohkat	sanoa
lohpidit	luvata
lohpádallat	kihlautua
loktet	nostaa
lonet	lainata
lonohallat	vaihdella
luddet	halkaista
luistet	luistella
luoddut	halkoa
luohttit	luottaa
luoikat	lainata
luoikkahit	lainata
luoitit	laskeutua
lágidit	järjestää
láhppit	menettää
láhppot	eksyä
láhttet	käyttäytyä
láibut	leipoa
láigohit	vuokrata
láittastuvvat	tylsistyä
lávet	ruukata
lávggodit	kylvetellä
lávggodit	kylpeä
lávgut	kylvettää
lávket	astua
lávlut	laulaa
manahit	menettää
mannat	lähteä
mannat	mennä
maŋŋonit	myöhästyä
mearkkašit	tarkoittaa
mearridit	määrätä
mearridit	päättää
merket	merkitä
messostallat	juhlia
miehtat	myöntyä
moddját	hymyillä
mojohallat	hymyillä
molssodit	vaihtaa
molsut	vaihtaa
moraštit	murehtia
moraštit	surra
morihit	havahtua
morihit	herätä
muitalit	kertoa
muitit	muistaa
máhccat	palata
máhccut	taitella
máhttit	osata
máistit	maistaa
máksit	maksaa
málet	maalata
mátkkoštit	matkustaa
nagadit	kyetä
nagadit	jaksaa
nagodit	selvitä
nahkehit	laittaa
namahit	nimittää
namuhit	nimittää
nannet	vahvistaa
niegadit	uneksia
nissut	niistää
njammat	imeä
njeazzát	irvistellä
njiellat	niellä
njoahcudit	hidastaa
njoallut	nuolla
njoammudit	tartuttaa
njoarostit	lassota
njoarrat	kaataa
njolodit	nuoleskella
njolodit	hyväillä
njorrestit	kaataa
njorret	kaataa
njuiket	hypätä
njuikut	hyppiä
njuoskat	kastua
njuovadit	teurastaa
njuovvat	teurastaa
njuovvat	nylkeä
njurggodit	viheltää
njuvdit	voidella
njáhkat	hiipiä
njárbat	nestemäinen
njávgit	naukua
njávgut	naukua
njávkkadit	silittää
noavkkuhit	imuroida
nohkat	kulua
nohkat	loppua
nohkkat	nukahtaa
nohkkat	nukkua
nuoladit	riisua
nuolahit	riisua
nuollat	riisua
nágget	inttää
náitit	naittaa
návddašit	nauttia
náđđát	jurottaa
náđđát	lymytä
oaggut	onkia
oahpahallat	opetella
oahpahit	opettaa
oahppat	oppia
oahpásmuvvat	tutustuminen
oaidnalit	tavata
oaidnit	nähdä
oaivvildit	tarkoittaa
oaivvildit	meinata
oalgguhit	motivoida
oasseváldit	osanottajat
oassálastit	osallistua
oastit	ostaa
oađđit	nukkua
oažžut	saada
ohcalit	etsiä
ohcat	etsiä
oidnot	näkyä
ollet	ehtiä
ollit	ehtiä
ordnet	järjestää
ordnet	laatia
orrut	asua
orrut	tuntua
orustit	pysähtyä
orustit	seisahtaa
plánet	suunnitella
páhkket	pakata
rahpat	avata
rahčat	raataa
rasttidit	ylittää
rasttildit	ylittää
ravgat	kaatua
rehkenastit	laskea
ribahit	päästää
riegádit	syntyä
riehčut	kirkua
riehčut	ulista
riessat	hapsuttaa
riessut	hapsuttaa
rievdadit	muuttaa
rigeret	meluta
rihpat	riistää
riidalit	riidellä
riidet	ratsastaa
roggat	kaivata
rohkadallat	rukoilla
rohttestallat	vedellä
rohttet	vetaista
rohttet	vetää
ruhtadit	rahoittaa
rullet	rullata
rullet	kääriä
runiidit	vihrentyä
ruohtastit	juosta
ruohttat	juosta
ruoksát	näkyä
ruoksát	“punottaa”
ruovgat	roukua
ruoškit	rytistä
ruvssodit	punastua
rádjat	varastoida
ráfot	rauhoittua
ráfut	rauhoittua
ráhkadit	tehdä
ráhkadit	valmistaa
ráhkistit	rakastaa
ráhkkanit	valmentaa
ráhkkanit	valmistautua
ráigánit	reikiintyä
rámohallat	kehuskella
ránodit	koittaa
rávkat	herättää
rávvet	neuvoa
sallut	syleillä
savdnjilit	ravistaa
savnnjašit	pudistella
savnnjašit	ravistella
seabbát	päilyä
seailut	säilyä
sealgádit	rökittää
searvat	osallistua
seastit	säästää
seavvit	vilkuttaa
sevnnjodit	pimetä
siedjut	märkiä
sihkestit	pyyhkäistä
sihkkelastit	pyöräillä
sihkkut	pyyhkiä
sihtat	pyytää
sihtat	haluta
sirdit	siirtää
skeaikit	nauraa
skeŋket	antaa
skurbat	kopeloida
skájihit	kajahtaa
skállat	kalista
skállat	kilistä
smiehttat	miettiä
smiehttat	ajatella
smáhket	maistaa
snelket	puraista
soaitit	saattaa
soaitit	voida
sojahit	taivuttaa
sorját	riippua
speallat	soittaa
spiehkastit	poiketa
stoahkat	leikkiä
stunžet	sotkea
stunžet	läiskyttää
stuoridit	suurentaa
stuorrut	suureta
suddat	sulattaa
sugadit	soutaa
suhkat	soutaa
suhtadit	kiukutella
suhttat	suuttua
suohpput	heitellä
suoládit	varastaa
suoskat	pureskella
suovastit	savuttaa
suovastit	savustaa
sáddet	lähettää
ságastallat	jutella
sáhttit	saattaa
sáltet	suolata
sárdnidit	saarnata
sárdnut	puhua
sárgut	piirtää
sávvat	toivoa
sávvat	toivottaa
tevdnet	piirtää
ujostallat	ujostella
vadjat	leikata
vajáldahttit	unohtaa
vajálduhttit	unohtaa
valástallat	urheilla
valáštallat	urheilla
veadjit	jaksaa
veahkehit	auttaa
veallát	maata
verrošit	fuskata
verrošit	keljuilla
viegahit	juoksuttaa
viehkalit	juoksaista
viehkat	juosta
viežžat	hakea
vizardit	visertää
vižardit	visertää
viššat	haukkua
viššat	uskaltaa
viššat	viitsiä
viššat	jaksaa
vuodjat	uida
vuodjit	ajaa
vuoidat	voidella
vuoigŋat	hengittää
vuoitit	voittaa
vuoiŋŋastit	levätä
vuojašit	ajella
vuolgit	lähteä
vuolgit	mennä
vuolšut	tulehtua
vuorddašit	odotella
vuorddestit	odottaa
vuordit	odottaa
vuosehit	näyttää
vuovdit	myydä
vuođgŋit	vaania
vuođgŋit	väijyä
vuoššat	keittää
váccašit	kävellä
váibadit	väsyttää
váibat	väsyä
váillahit	kaivata
váilut	puuttua
válddahit	kuvata
váldit	ottaa
válljet	valita
várjalit	varjella
váruhit	varoa
vástidit	vastata
vázzit	kävellä
áddet	ymmärtää
ádjánit	juuttua
ádjánit	viipyä
áicat	huomata
áicat	nähdä
áigut	aikoa
áitit	uhata
álggahit	aloittaa
álgit	alkaa
állanit	kallistua
árvalit	arvella
árvidit	arvata
árvidit	ymmärtää
árvvoštallat	arvioida
árvvoštallat	arvostella
ássat	asua
ávvudit	juhlia
áŧestit	ahdistaa
šaddat	kasvaa
šaddat	joutua
čaibmat	nauraa
čalmmástuvvat	kyllästyä
časkit	lyödä
časkit	iskeä
čatnat	sitoa
čađahit	toteuttaa
šealgut	loistaa
šealgut	kimmeltää
šearrát	loistaa
čiehkat	piilottaa
čiehkádit	piiloutua
čiehkádit	kätkeytyä
čiehkástallat	piileskellä
šiehttat	sopia
šiehttat	mahtua
čiekčat	potkia
čierastallat	lasketella
čierastit	laskea
čierrut	itkeä
šiggut	torua
šiggut	vaientaa
šiggut	häätää
čilget	selittää
čiŋadit	koristautua
čiŋahit	koristella
čiŋkut	konkata
čiŋkut	kinkata
šleađgut	välkkyä
šlundut	masentua
čoagganit	kokoontua
čoaggit	kerätä
čoaggit	poimia
čoaskut	kylmetä
čohkiidit	kokoontua
čohkkedit	istahtaa
čohkkedit	istuutua
čohkkedit	kokoilla
čohkkát	istua
čohkohallat	istahdella
čohkohallat	istuskella
čohkánit	istuutua
čollet	suolistaa
čorgestallat	siivota
čorgestallat	järjestää
čorget	siivota
čugget	pistää
čujuhit	osoittaa
čuodjat	soida
čuoggut	pistellä
čuohcat	kohdistua
čuohkat	latkia
šuohkkit	huokailla
čuohppat	leikata
čuoigalit	hiihdätää
čuoigat	hiihtää
čuoiggadit	hiihdellä
čuoiggadit	hiihtää
čuoiggahit	hiihdättää
čuojahit	soittaa
čuojahit	soita
čuojihit	kilahtaa
čuollat	iskeä
čuollat	hakata
čuorvut	huutaa
čuorvut	huuhdella
čuovvut	seurata
čuoččat	seisaalla
čuožžut	seistä
čuožžut	seisoa
čuvggodit	valjeta
čuvodit	seurailla
šuvvat	kohista
šuvvat	suhista
čuččodit	seisoskella
čáhkat	mahtua
čájehit	näyttää
čájáhallat	näyttää
čájáhallat	näytellä
čákŋalit	astua
čállit	kirjoittaa
čárvut	puristaa
čárvut	puristella
čárvvodit	puristella
adopteret	adoptoida
adresseret	osoittaa
agáiduvvat	ikääntyä
aiget	räkättää
albmadit	ilmiantaa
albmaduvvat	ilmaantua
albmanit	ilmetä
allánaddat	kohoilla
almmaiduvvat	ilmaantua
almmáiduvvat	miehistyä
aman	etten
amastit	vierastaa
arggosnuvvat	piristyä
arvvalaš	tarmokas
arvvašit	sadella
arvvuhuvvat	lannistua
assáduvvat	äksyillä
avvit	vuotaa
aškkastit	paantaa
bahtadit	ahmaista
bahčilit	lypsäistä
bahčásit	pusertua
bahččot	pusertua
bahččut	katkeroitua
bajásdoallat	ylläpitää
bajásgeassit	kasvattaa
baladit	pelkäillä
baldalit	pelotella
balddihit	pelästyttää
balddáhallat	pelotella
bardáladdat	ladella
basahit	pesettää
basttehuvvat	tylsyä
bažašit	lypseskellä
beagašit	konttailla
beahttašuvvat	pettyä
beahttit	pettää
beaitalit	peitellä
beaitáladdat	peitellä
beavttálmahttit	tehostaa
beavttálmuvvat	tehostua
beađadit	puhkoa
beaškkehit	törmätä
befeštuvvat	jännittyä
beiset	petsata
beljohallat	kuulostella
beljostallat	kuulostella
bestet	pestata
biertaluvvat	pelästyä
bievvalastit	mestata
bihkkadit	tervata
bihčut	piipittää
biktalit	lämmitellä
bilbut	horjua
bilket	pilkkiä
bilkidit	pilkata
binddastit	pinkaista
bindut	pinkoa
birračuohppat	ympärileikata
bivttastit	vaatettaa
boahkuhit	rokottaa
boahkánastit	vyöttää
boaisut	kalppia
boalbut	kompuroida
boalddašit	poltella
boalddáldahttit	rynnistää
boaluhit	napittaa
boalčasit	nyrjähtää
boalččihit	linkata
boanddaiduvvat	vaurastua
boandut	vaurastua
boarskudit	nolata
boatkanaddat	katkeilla
bodnjasit	vääntyä
bogostallat	naureskella
bohkat	porata
bohkosit	naurahtaa
bohttehit	turvottaa
boikohttet	boikotoida
bokset	nyrkkeillä
boktalit	herätellä
bolastit	ryöpsäyttää
bolffagit	tuuhettua
bollát	könöttää
boret	porata
borgalit	tuprauttaa
borggadit	pyrytellä
borgáhit	tupruttaa
borjjastit	purjehtia
bosodit	puhallella
bovttihit	herätyttää
buddáduvvat	velkaantua
buhtistit	puhdistaa
buhtásmit	puhdistua
buljagit	pullistua
buljardahttit	kurlata
bullehit	sytyttää
bunzzardit	nikartaa
bunčalit	polskauttaa
bunččihit	polskahtaa
bunžáhit	hotkia
bunžžuhit	hotkia
buoguiduvvat	ajettua
buohtalastit	rinnastaa
buoidudit	lihottaa
buoidut	lihoa
buokčat	sukeltaa
buolláhit	sytyttää
buollát	syttyä
buoskáruššat	puoskaroida
buovnnjagit	kärventyä
buovččadit	sukellella
buozadit	sairastella
buođgát	pilkottaa
buoššudit	paaduttaa
burskkihit	purskahtaa
busket	pieraista
buvihit	kuristaa
buškalit	sujauttaa
báffat	pauhata
báhkadit	kuumentaa
báhčalit	ammuskella
bákkuhit	pakottaa
bákŋat	maikkua
bálddalastit	rinnastaa
bálkkašit	palkita
bálvvuštit	palvoa
bánžat	pöhöttyä
bánžžagit	pöhöttyä
bárket	parkita
bávtat	paantaa
cahkat	kyteä
cahkkát	syttyä
cahppát	häämöttää
cavkkihit	sammahtaa
cielkkistit	kalista
cillat	kilistä
cimirdit	nitistää
cimput	loikkia
civzziidit	karvastella
covdnašuvvat	havahtua
cubistit	ryystää
cuhpat	ryystää
cuiláhit	viilettää
cukcat	nalkuttaa
cullat	tuudittaa
culláhit	tuudittaa
cuskkihit	tuhahtaa
cuvistit	ryystää
cuvzat	nalkuttaa
cuŋkalit	muiskauttaa
cáhkastit	ähkäistä
dadnet	tinata
daguhit	suostuttaa
dalkkihit	tupsahtaa
davkkildit	näpistellä
davrragit	kurttaantua
deabbut	lientyä
deahpánit	litistyä
deajihit	välkähtää
deamihit	tömähtää
deapmat	tömistä
deattašit	painella
deaškalit	lätkäyttää
deaškasit	lätkähtää
deaškašuvvat	lätkähtää
deaškkastit	lätkäistä
deaškkihit	lätkähtää
deaškkuhit	lätkytellä
deaškut	lätkiä
deaššat	lipua
defineret	määritellä
destilleret	tislata
devkkodit	himmetä
dibmet	pehmittää
dielgŋat	kyllääntyä
dielvvásmuvvat	tasoittua
dierdidit	sättiä
dievasmahttit	täydentää
dikteret	sanella
diktet	runoilla
dilket	tilkitä
dipmat	pehmetä
divaštallat	kinastella
divsket	tiuskahtaa
divskut	tiuskia
divttásmit	tiivistyä
divttásmuvvat	tiivistyä
divššodit	hoidella
doaibat	riutua
doaktáruššat	tohtoroida
doarškalit	läimäyttää
doarškit	läimähdellä
doaškalit	läimäyttää
dorvádit	turvautua
dovddastit	tunnustaa
dugordallat	leikkiä
duhastit	tuulastaa
duhkoraddat	leikkiä
duhkordallat	leikkiä
duhtadit	tyydyttää
duktet	lannoittaa
dulmmodit	poljeskella
dulppagit	tylpistyä
dumssagit	vanua
duoggudit	takkuunnuttaa
duoggut	takkuuntua
duogurdit	leikkiä
duohččat	säästää
duvhllidit	tuhlata
duvttaiduvvat	lannoittua
duđahit	tyydyttää
duškalit	polskauttaa
duškidit	polskia
duššástuvvat	turhautua
dáddjet	möyhentää
dáhkadit	uuvuttaa
dálkkastit	lääkitä
dálkkodit	lääkitä
dálkut	lääkitä
dápmasit	kesyyntyä
dápmašuvvat	kesyyntyä
dárihit	kiivastua
dáruiduhttit	norjalaistaa
dáruiduvvat	norjalaistua
dásáiduvvat	tasaantua
dásásmit	tasaantua
dásásmuvvat	tasaantua
dávžat	soudella
dávžut	soudella
eai	eivät
eaibmudit	koheltaa
eaidadit	vieraannuttaa
eaiggáduššat	omistaa
eamidastit	emännöidä
eanaiduvvat	maatua
eastat	estyä
eastašuvvat	estyä
eat	emme
eatnehit	ennättää
eavddáruššat	tuhlailla
eaškálahttit	nyrjäyttää
eaškálit	nyrjähtää
eaškáluhttit	nyrjäyttää
ehpet	ette
faggut	koukkailla
fakkastit	koukata
fakŋalahttit	kurkottaa
fasket	raapaista
fastudit	rumentaa
fastut	rumentua
feasttašit	hinailla
fereguššat	käyttätyä
fidnáruššat	saalistaa
fievrrádaddat	kuljetella
fiilet	viilata
finadit	käväistä
finihit	käväistä
fiŋggodit	sätkytellä
fiškalit	sivaltaa
fiškasaddat	hyöriä
fuoikit	voihkia
fuoikkádit	voihkaista
fuoikut	voihkia
fuolahit	huolehtia
fuorástit	huorata
fággádit	painia
fáippihit	huiskahtaa
fáladit	tarjoutua
fávllidit	loitontaa
gaccastit	raapaista
gahput	kermoittua
gaikánit	repeytyä
galjidit	väljentää
galljánit	väljetä
garradit	kovettaa
garret	kuoria
gaskkalduhttit	keskeyttää
gassuhit	usutella
gastit	aivastaa
gatnjaluvvat	kyyneltyä
gažadit	kuulustella
geassastit	valjastaa
geađgádit	kivittää
gefot	köyhtyä
genddot	kääntyä
geđđot	häikäistyä
giebahit	noeta
giehtadallat	käsitellä
giektat	noeta
giellut	hyytyä
gievrrastallat	voimailla
gihládit	kihlata
gihppet	niputtaa
gildát	kukoistaa
gilkkihit	kilkuttaa
girdnet	kirnuta
girdnot	kirnuta
girdnut	kirnuta
girjjogárjjohallat	kirjoa
girtat	tarjeta
gissat	mekastaa
givšttidit	mekastaa
goabagit	kupristua
goalkkuhit	kolkuttaa
gobmidit	kummitella
gohccát	herätä
gohcut	ripustella
goldnat	kuihtua
gollet	kullata
gopmat	kumista
gopmirdit	kumartaa
gosahit	yskittää
gosádit	yskäistä
govket	raottaa
gozastit	ripustaa
gožuduvvat	nokeentua
gudnet	tuhkata
guhkkat	kukkua
guhppet	kupata
guittidit	kuitata
gulaskuddat	tiedustella
gulcat	nyrhiä
gulkat	jystää
gullet	kalastaa
guoddalit	kannella
guoddalit	valittaa
guoggaruššat	kyyrötellä
guoggut	kyyröttää
guohkkat	kuokkia
guohpput	homehtua
guolljut	puskea
guolástit	kalastaa
guorsat	köhiä
guoskkahit	koskettaa
guostát	häämöttää
gurdit	jystää
gurehit	kurittaa
guđaidit	kuhista
gádjalit	varjella
gáhtat	katua
gáivut	huitoa
gáivvihit	huiskahtaa
gárihuvvat	humaltua
gávildit	kavaltaa
gáđaštit	kadehtia
hahcuhit	härnätä
hahppit	pulputtaa
hapmudit	persoilla
harcasit	hirttyä
harret	murahtaa
havssiidit	haista
heahkkalastit	virkata
heahpanaddat	häpeillä
heahpanit	hävetä
heahppášuhttit	häpäistä
heaibat	viipyä
heaibut	painia
hearidit	häärätä
hearrástallat	herrastella
hearvvahit	koristella
heavvalastit	höylätä
heaŋgut	ripustella
helssodit	huljutella
hierdašuvvat	hankautua
hihttát	hiihtää
hihtut	hidastua
hilcasaddat	huikennella
hilcudit	huikennella
hilgut	hylätä
hirasmit	vauhkoontua
hirasmuvvat	vauhkoontua
hirpmahit	pelotella
hirrudit	vauhkoonnuttaa
hirrut	vauhkoontua
hiđásmuvvat	hidastua
hiđástuvvat	hidastua
hiŋkkašit	nyyhkiä
hiŋkkihit	nyyhkäistä
hiŋkkádit	nyyhkäistä
hoagihit	hokaista
hoahkat	hokea
hoahkidit	hoeskella
hoaiggardit	hyräillä
hoamssistit	jaaritella
hoddet	älytä
hohpohit	hoputtaa
hoitát	hoitaa
holvvodit	ulvoskella
huhccalit	usuttaa
huhcuhit	usutella
huikkihit	huudahtaa
huikkihit	huudattaa
huilát	vilettää
hulaidit	hyräillä
hulardit	hörähdellä
hullat	turista
humaidit	mutista
hurihit	hyrähtää
hurvvagit	masentua
huvdet	kurittaa
háddjet	hajottaa
háistit	haistaa
háldet	hallita
hálset	halssata
háset	haasioida
háskkidit	haaskata
hávkkádit	haukahtaa
hávvudit	haavoittaa
hávvádahttit	haavoittaa
hávvádit	haavoittaa
háđirdit	hutiloida
háŋgut	hangota
háŋkasaddat	parveilla
it	et
jabbut	mulkoilla
jahlidit	jyrsiä
jalkát	rötköttää
jallat	jymistä
jaraidit	narista
jeagadit	totella
jeagálduvvat	jäkälöityä
jeavdašuvvat	tasoittua
jeađđašuvvat	lohduttautua
jiebbadit	kainostella
jierbmat	järkiintyä
joahcat	jymistä
joatkašuvvat	jatkua
jollardit	lyllertää
joppaldahttit	mutustaa
joppaldit	mutustaa
jorbbasmit	pyöristyä
jorbbasmuvvat	pyöristyä
jozzidit	höpöttää
juleštit	ahnehtia
jumihit	jymähtää
juoksut	riittää
juolgat	jalkaantua
juorrudit	juoruta
juraidit	jyristä
jurbmát	kyyhöttää
juskalit	jysäyttää
juskkihit	jysähtää
juskkuhit	jyskyttää
jussut	piereskellä
justit	jystää
jábáiduvvat	vaurastua
jámálgit	pyörtyä
jástit	ahmia
játnat	kutistua
játtihit	sammahtaa
jáválduvvat	vaurastua
kihttet	kitata
kiiket	kiikaroida
kiikkárastit	kiikaroida
koasttidit	kustantaa
kruvnnidit	kruunata
kviteret	kuitata
kálket	kalkita
laggat	sykkiä
lahppasit	hengästyä
laigat	lohjeta
laktit	liittää
laktit	monistaa
laktásit	liittyä
lapmut	lumoutua
leandit	kiitää
leháhit	sadatella
leŋget	valjastaa
liekkadallat	lämmitellä
liekčát	retkottaa
lihkastahttit	liikauttaa
litnjat	painua
livdnet	taksoittaa
liđggastit	vilkaista
loahppat	loppua
loaidat	astua
loaskkuhit	läimäytellä
loavkašuvvat	loukkaantua
logget	irrottaa
lohkkadit	lukita
lohppehit	juoksetuttaa
lohppet	juoksettua
lonistit	lunastaa
losidahttit	raskauttaa
lotnut	lunastaa
lotnut	maksaa
lottástit	linnustaa
lovpet	karata
lovsset	luotsata
luddat	läkähtyä
ludnet	roskata
luohčásit	liukastua
luoillistit	märistä
luokčat	taltata
luonddahuvvat	voipua
luovvanit	irrota
lutnjat	ruikuttaa
luvvet	irrottaa
luvvet	ratkaista
luđet	ladata
láddet	panostaa
láddjet	niittää
láhtut	latoa
láikkohallat	laiskotella
láikkástallat	laiskotella
láikut	laiskistua
láittašit	moitiskella
lákcut	kermoittua
láktadit	kostuttaa
láktat	kostua
lálláhit	tuutia
lásset	lukita
lástet	lastata
lávllodit	lauleskella
marššuhit	taapertaa
massit	menettää
meafardit	tallustaa
meagádit	määkäistä
meallut	meloa
mearkadit	merkitä
megodit	määkyillä
mieiggastit	nojautua
mihtidit	mitata
millet	jauhaa
milohallat	mieliä
mirkkohit	myrkyttää
misset	heroittua
misttahit	erehtyä
moarrasit	murtua
moaráhuvvat	raivostua
moaráskit	vihastua
moldet	murentaa
monnut	munia
moriidit	herätä
moskát	mököttää
movttáskit	innostua
mozzasit	taittua
mozzidit	nahistella
muhkut	ammua
muhttot	muuttua
muidet	tinata
muitáhit	muistuttaa
muldet	mullata
mulggádit	mulkaista
mulgut	mulkoilla
mulččihit	lipsahtaa
munnet	kyetä
muoddáluvvat	kulua
muoladit	mölistä
muollat	mölistä
muoládit	mölähtää
muŋkát	mököttää
máihlut	mahloittua
máinnašit	mainita
máinnašit	kehua
máistot	maistua
máltit	malttaa
mánet	manata
mánidit	manata
máset	jankuttaa
mávssihit	maksattaa
naigguhit	muksia
navistit	nykäistä
nearrat	tylsyttää
niehkudit	haaveilla
nihlaidit	hihittää
nihlistit	hihittää
nihttit	uhkailla
niitit	niittää
nirvut	virneessä
nivssihit	suutahtaa
njahkahastit	nikotella
njahkastit	nikotella
njahppit	nykiä
njalkasit	luiskahtaa
njalkkihit	liukastua
njaláhastit	liukastua
njamistit	imaista
njammásit	imeytyä
njanzát	rötköttää
njattiidit	maittaa
njeazzut	irvistellä
njeaššut	rapakoitua
njeđgot	tuiskuttua
njielastit	nielaista
njigaidit	kimittää
njirdot	harhaantua
njirgalit	ruikauttaa
njirget	ruikata
njivkkihit	inahtaa
njivkkádit	inahtaa
njiđđat	luisua
njoahcut	hidastua
njoaidduiduvvat	loiventua
njoaiddut	loivempi
njoalostit	nuolaista
njoaradit	kaadella
njoiddosmit	loiventua
njoiddosmuvvat	loiventua
njunnet	vainuta
njuorddáhallat	alistua
njuozzut	kaulita
njurgut	viheltää
njálgganjuokčamastit	makeilla
njáskasit	karsiintua
njávggihit	naukaista
njáđđut	madaltua
njáŋgasit	rötkähtää
noavkalit	hotkaista
noavkkádit	hotkaista
noađuštit	sälyttää
nohkkadallat	nukutella
nohkkadit	nukuttaa
nollagit	kyykistyä
nolliidit	kyykistyä
notkasit	tukkeutua
notkašuvvat	tukkeutua
nuhkuštit	retuuttaa
nuissodit	tallustella
nuktalit	nuhdella
nummarastit	numeroida
nuohttut	nuotata
nuondat	voipua
nuorasmit	nuortua
nuorasmuvvat	nuortua
nuovvut	liestyä
nurddagit	tylpentyä
nursahuvvat	tylpentyä
nurssagit	tylpentyä
nurššagit	turvottua
náiggistit	vapista
nálset	naljailla
námonistit	tungetella
návrruhit	pilkata
náššat	hankkia
oaffaruššat	uhrata
oahpásmit	tutustua
oamážastit	omia
oasttihit	ostattaa
oaččástit	irstailla
obehit	opettaa
oidit	suosia
oktet	yhteyttää
ološit	paljoksua
onnestuvvat	onnistua
ostašuvvat	parkkiintua
ozadit	etsiskellä
plokket	aurata
pumpet	pumpata
pántet	pantata
rabihit	räpsähtää
rahpastit	kiskaista
rahppasit	tipahtaa
ravggadit	kaatuilla
ravggodit	tempoilla
ravččuhit	räpiköidä
raŋgalit	kellistää
raŋggagit	kellistyä
raŋgádit	rötköttää
reaggánit	uupua
reavgut	röyhtäillä
rehkenuššat	laskea
rehkket	riittää
ribahuvvat	roskaantua
riegádahttit	synnyttää
riehpat	pilaantua
riejihit	rähähtää
riektat	oiustua
rievidit	ryöstää
riggat	turvota
riggut	rikastua
rihkkašuvvat	vahingoittua
rihpastit	nakata
rihpašit	ripittää
rihpput	nakkoa
riibat	säilyä
riitát	riittää
riššudit	hätiköidä
roahkasmit	rohkaistua
roahkasmuvvat	rohkaistua
roaiskkuhit	ruoskittaa
roandit	harsia
roaskut	roskaantua
ropmudit	rumentaa
rosset	askaroida
rostet	uskaltaa
roŋget	ärähtää
rožagit	kaventua
rudnet	inua
rufanastit	hutiloida
ruhpaluvvat	sakkautua
ruhttet	nuohota
ruhttet	rahoittaa
ruivalit	hutiloida
runcet	töhertää
runzet	mässäillä
ruodjadit	metelöidä
ruodjat	metelöidä
ruohkadit	raaputella
ruohkastit	raapaista
ruohtastuvvat	juurtua
ruoidnadit	laihduttaa
ruoidnat	laihtua
ruosadit	kompuroida
ruostut	ruostua
ruovrut	härskiintyä
ruskat	roskittua
russat	ruikata
russiinávlet	ristiinnaulita
rustát	rustata
rusádit	pärskäyttää
ruvaštit	puhaltaa
ruvdet	raudoittaa
ruvvet	hieroa
ruŋkit	ronkkua
ruŋkkistit	ronkkua
ruššudit	hutiloida
ružžut	vollottaa
ráfohit	rauhoittaa
ráfáiduvvat	rauhoittua
rággalit	mätkäyttää
ráhkistuvvat	rakastua
ráidnet	puhdistaa
ráikkistit	mekastaa
ráikut	ruoskia
rákkihit	mätkähtää
rámbut	rampautua
rámidit	ylistää
rássut	ruohottua
rátnut	harmaantua
rávnnuiduvvat	kuntoutua
rávvohallat	muistutella
ráđđidit	neuvotella
ráđđádallat	neuvotella
ráškalit	mätkäyttää
ráškkihit	mätkähtää
rážžat	punoittua
sahkkehit	hedelmöityä
sahát	sahata
sarčut	hypellä
seabbát	päilyä
seaguhit	sekoittaa
seavlašuvvat	seuloutua
sehkket	sekoittaa
sevlet	seuloa
sevnnjodahttit	pimentää
seŋket	myöhästyä
sihkkasit	pyyhkiytyä
sihkkašuvvat	pyyhkiytyä
siigat	lipua
silbet	hopeoida
sirgŋat	väljentyä
sitnut	ruohottua
sitnáduvvat	sisuuntua
sivahit	syyttää
siđasmit	käheytyä
siđasmuvvat	käheytyä
siđđut	käheytyä
skarkit	korista
skarkkihit	korahtaa
skeavkáhit	sipsuttaa
skeaŋkut	lahjoitella
skebmet	viivästyttää
skierbmut	ontua
skierpmádit	onnahtaa
skievvidit	hermoilla
skihččát	törröttää
skilahit	kilistää
skilihit	kilahtaa
skilkit	kilkattaa
skilkkihit	kilkuttaa
skilkkuhit	kilkuttaa
skillat	kilistä
skoldašuvvat	kalttautua
skoldet	kaltata
skruvet	ruuvata
skuhčat	kikattaa
skuldot	torua
skuolljut	puskea
skurvvagit	masentua
skutnjat	tirskua
skuvret	kuurata
skužaidit	kikatella
skužistit	kikattaa
skáhppot	hankkia
skátnjat	kimittää
skávžut	parroittua
skáđet	haitata
skáđđašuvvat	vahingoittua
smarvvagit	kihartua
smiergguhit	rouskuttaa
smiergit	rouskua
smirezastit	märehtiä
smirezit	märehtiä
smoldet	murentaa
smovhlet	ahmia
smulket	silputa
smurtet	mustata
smurtet	teniä
smáhkiidit	maistua
snahpastit	torkahtaa
snahppot	torkkua
snievkkuhit	viillellä
sniiggáruššat	nuukailla
snorrasit	kuroutua
snuhrrat	kuorsata
snurkit	röhkiä
snurkkihit	röhkäistä
snuskit	nuuskuttaa
snuskkihit	nuuskauttaa
snuvsset	nuuskata
snuđádit	niiskauttaa
snuđđat	niiskuttaa
snuđđut	niiskuttaa
snárkut	sykertyä
soabahallat	sovitella
soaikut	harsia
soalssistit	kuolata
soarvut	keloutua
soađástallat	pistellä
soidadit	laimentaa
soktaluvvat	vaahtoutua
soradit	sotkeutua
sovkalit	kuiskata
sovkkuhit	kuiskuttaa
spargalit	täräyttää
spargguhit	värisyttää
spatnjat	kimittää
spiehkkasit	poiketa
spihkodit	poukkoilla
spiiddistit	kirvellä
spiidet	kirvellä
spinjaidit	kimittää
spoahttat	pilkata
spoatnut	paakkuuntua
spovet	povata
spulet	puolata
spáhkkalastit	paklata
spáitit	tehota
spáret	säästää
spárvet	sorvata
srubistit	hörpätä
stađđat	malttaa
steaikalit	hurauttaa
steampalastit	leimata
steamput	tallustaa
steanžut	tallustaa
steaččihit	lätkähtää
steažžasit	litistyä
stemmet	äänestää
steŋget	sulkea
stiivet	tärkätä
stirrát	tuijottaa
stivát	kinastella
stoavkit	maiskuttaa
stoavkkuhit	maiskutella
stohppet	parsia
stohppet	pysähtyä
stohppádit	parsia
strubistit	hörpätä
struhpat	hörppiä
stužaidit	loiskia
stágget	harsia
stávrruhit	koikkelehtia
suhtihit	suutahtaa
suhttadit	suututtaa
suodjalit	suojella
suoggat	kostautua
suohkanastit	naarata
suoivvihit	häilähtää
suonjardit	säteillä
suorranit	haarautua
suostat	laiminlyödä
suostut	lahota
suovvadit	savuttaa
surggohallat	surkutella
sustilit	nuuhkaista
sustit	nuuhkia
suvrragit	hapettua
suvrrustit	suurustaa
suvččagit	paleltua
ságastit	puhella
sáhkohit	sakottaa
sáivvildit	kuolata
sállet	sallia
sárjjastit	kirvellä
sárjádit	haavoittaa
sávdnjet	saumata
sávdnut	saunoa
sávdnádaddat	saunoa
teahtásmit	tiivistyä
telegraferet	sähköttää
testamentet	testamentata
tigget	tinkiä
trillet	kärrätä
tullet	tullata
udjosaddat	ujostella
udjosit	ujostua
urddistit	uurtaa
usket	uhata
uštit	uistella
vabaidit	väpättää
vaháguvvat	vahingoittua
vajálduvvat	unohtua
vatnalit	venähtää
vašuhit	vihata
veaisidit	veisata
vealggáiduvvat	velkaantua
vealgut	velkoa
vealgáduvvat	velkaantua
vealtit	välttää
veavttastit	liioitella
veažirdit	vasaroida
verjet	aseistaa
vesáiduvvat	vesoittua
vesáluvvat	vesoittua
vieccistit	pinnistellä
viehkástallat	viekastella
vihkket	punnita
vihpadit	viivyttää
vihpat	viipyä
viibat	viipyä
viissástallat	viisastella
viisudit	viisastuttaa
vikšadit	vyyhdetä
vikšet	vyyhdetä
villat	sännätä
vilppastit	vilkaista
vilppihit	vilkaista
vilppádit	vilkaista
vilššastit	vilkaista
vilššádit	vilkaista
vinjagit	vinoutua
vuodjalit	ajella
vuohppát	huovata
vuoigit	voivotella
vuoiŋŋidit	moittia
vuoiŋŋihit	hengähtää
vuojahit	uittaa
vuolládastit	alistua
vuolšudit	tulehduttaa
vuonjasmit	kesyyntyä
vuonjasmuvvat	kesyyntyä
vuorbádit	arpoa
vuorddildit	odotella
vuordnut	vannoa
vuovdalit	markkinoida
vuovssadit	oksentaa
vurderet	arvioida
váddudit	vaikeuttaa
váddut	vaikeutua
váikkuhit	vaikuttaa
vájuldit	vaeltaa
válbmanit	valmistua
válbmet	valmistaa
válddihit	otattaa
vátnat	sorvata
váttásmit	vaikeutua
váttásmuvvat	vaikeutua
vávašit	kummeksua
vávvát	tuijottaa
ádelastit	aateloida
áhcagahttit	hehkuttaa
áhcahit	hitsata
áhpásmit	virkistyä
áidut	aidata
áitáladdat	uhkailla
ákkastit	perustella
álddagastit	salamoida
állanaddat	kallistella
állohallat	kallistella
ánssášit	ansaita
árbet	periä
árkkálmastalit	säälitellä
árpmihit	armahtaa
árpmášit	sääliä
árrásuvvat	sierettyä
árvidahttit	arvuuttaa
árvádahttit	arvuuttaa
árvádallat	arvailla
árástuvvat	aristua
ásodit	asustella
ássut	haasioida
ávkkuhit	hyödyttää
ávkkáiduvvat	hyötyä
ávžut	kehottaa
áđđet	matkia
áŋkorastit	ankkuroida
áššut	hiiltyä
áššáiduhttit	syyttää
áššáskuhttit	syyttää
áŧestuvvat	ahdistua
čahrrat	räkättää
čaimmehit	naurahtaa
čallidit	hekotella
čarkkistit	räkättää
čeahkut	ahmia
čeakŋagit	kyykistyä
čeallut	loikkia
čeargat	kinostaa
čearidit	niittää
čearssistit	virnuilla
čeavžut	tallustaa
čekŋohallat	kyykistellä
čeret	niittää
čiegadit	piilotella
čiehkádallat	piileskellä
čiekŋudit	syventää
čiekŋudit	paneutua
čieruhit	itkettää
čigŋát	koreilla
čihttet	kitata
čirrat	lohjeta
čoavdašuvvat	ratketa
čolgadit	sylkäistä
čolgat	sylkeä
čolggadit	syljeskellä
čomastit	parveilla
čoppaldit	mutustella
čorpmastallat	nyrkkeillä
čovvát	siepata
čulkit	kolista
čulkkihit	kolahtaa
čuoibmut	sauvoa
čuolbmat	solmia
čuonádit	ahmaista
čuopmat	suomustaa
čuovggahuvvat	sokeutua
čuoččildit	seisoskella
čuođđit	rykiä
čurtet	pyllistää
čurtát	pyllistellä
čurvoladdat	huudahdella
čuvddástit	hypistellä
čuvdet	nyppiä
čuvkuluvvat	juoksettua
čuvkut	juoksettua
čábbut	kaunistua
čávvat	valua
šaluiduvvat	vettyä
šieđđaluvvat	hengästyä
šieđđat	läähättää
šiitit	kiistää
širaidit	ryöpytä
širgalit	ryöpsäyttää
širgguhit	ryöpyttää
širihit	ryöpsähtää
širrat	ryöpytä
šleaippástuvvat	rasittua
šleambit	hotkia
šleambut	hotkia
šleancát	lerpattaa
šliipet	tahkota
šlinzzagit	pehmetä
šloaŋkkistit	lonksua
šluŋkkistit	lerpattaa
šláktet	teurastaa
šlámaidit	meluta
šláttardit	juoruta
šlávehallat	luovia
šlávehit	luovia
šlávet	luovia
šnjivaidit	kärytä
šnjivihit	kärähtää
šnjivvat	kärytä
šnjoaraidit	liristä
šnjoarggihit	lirahtaa
šnjoargguhit	liruttaa
šnjoargut	liristä
šnjoarrat	liristä
šoaŋkkuhit	lönkytellä
šombbistit	sössöttää
šombbárastit	sössöttää
šuddidit	hälistä
šumppihit	jysähtää
šuohkihit	huokaista
šállošit	sääliä
ahkiduššat	ikävöidä
ahkiduššat	pitkästyä
aresteret	pidättää
aresteret	takavarikoida
arestet	pidättää
arestet	takavarikoida
attildit	pyyhältää
bahčagit	katkeroitua
basihit	paistattaa
beahkáladdat	konttailla
beaivváiduvvat	vaurastua
bealjehuvvat	kuuroutua
bearrat	sukeutua
beaskidahttit	kerityttää
beađahit	puhkaisuttaa
beađđat	puhkaista
beađđat	nirhaista
biestit	päästättää
boatkut	katkoa
boatkut	pätkiä
bonjadit	väännellä
bonjahit	väännättää
bunžalit	hotkaista
buoruštit	maanitella
burgásit	purkautua
báhkkanaddat	kuumentua
báhkkanaddat	hermostua
báhtaraddat	pakoilla
báinnihit	värjäyttää
bálkestahttit	heitättää
bálkestahttit	heittäytyä
cibmut	nitistää
cibmut	rutistaa
cieladit	haukuskella
dahkaluddat	teeskennellä
dahkaluddat	tekeytyä
dassat	tuupata
davkasit	peittyä
deavdalit	täytellä
dierbut	hölöttää
divvulit	laittautua
doadjásit	taittua
doaivvuhit	toivoskella
doaivvuhit	toivottaa
dorvvastit	turvata
dorvvastit	turvautua
dorvvuhuvvat	masentua
dovdot	tuntua
dovdot	ilmetä
dubmet	tuomita
dubmet	päättää
dulbet	tasoittaa
dulbet	latistaa
duskkástuvvat	tuskastua
duskkástuvvat	ärtyä
dáraidit	kiivailla
dáraidit	tuhahdella
dávggasmit	joustavoitua
dávggasmit	sitkastua
dávggasmuvvat	joustavoitua
dávggasmuvvat	sitkastua
dávgut	retuuttaa
fáškalit	selättää
gahkit	kalvaa
gargit	kipunoida
gargit	ryöpytä
geahččaladdat	koetella
geahččaladdat	kokeilla
gerjjodit	mielistellä
geđget	kivetä
geđget	kivittää
girddašit	lennellä
gohpat	kovertaa
gohpat	kaivertaa
golluhit	kultailla
gorkŋodit	kiipeillä
gorkŋodit	sauvoskella
govdut	kellua
govdut	lainehtia
gozihit	vahtia
gozihit	valvottaa
gulahit	kuuluttaa
guohpasit	poimuttua
gálihit	kahlauttaa
gáskkašit	pureskella
gáskkašit	raadella
haraidit	murista
haŋkit	kaakattaa
haŋkit	änkyttää
heahtašuvvat	häiriintyä
heaŋggastit	ripustaa
hehttot	joutua
hehttot	täytyä
hoallat	jaaritella
hoallat	puhua
humeštit	puhuskella
humeštit	motkottaa
humihit	humahtaa
hálahallat	puhutella
hálbbidit	halventaa
hálbbášit	halveksia
hárjehit	harjoittaa
hárjehit	valmentaa
hárčet	harpata
hárčut	haarotella
hárčut	harppoa
hásket	raadella
hávvut	haavoittaa
hávvut	raadella
jáfet	ahmia
jámadit	kuoleskella
knihppet	puida
knihppet	nyrkkiä
leiret	parkita
leiret	vuotaa
lohkket	väistää
lohkket	torjua
loiket	haalentaa
mannet	munia
meroštallat	arvioida
meroštallat	määritellä
messet	messuta
messet	juhlia
molsašuvvat	muuttua
mánnat	ilkkua
mánnat	petkuttaa
navddašit	nimitellä
navddašit	oletella
navdit	olettaa
navihit	nyittää
nealgudit	nälkiinnyttää
neavvut	neuvoa
neavvut	suositella
nevvodit	neuvoskella
nevvodit	suositella
nevzzodit	nytkytellä
njalkkastit	liukastua
njalkkastit	luiskahtaa
njavggodit	silottua
njiehcadit	veltostuttaa
njivlut	limoittua
njohcut	silmustaa
njárbudit	harventaa
njárbudit	ohentaa
njárbut	harventua
njárbut	laimentua
nuhkkalit	nykäistä
nuhkkalit	nyökätä
nárret	narrata
nárret	kiusoitella
oađđáhit	nukuttaa
ođastit	uudistaa
reavgit	röyhtäillä
reavgit	räkättää
rihccut	loikkia
roahppánit	menehtyä
ruddet	maustaa
ruovddástuvvat	karaistua
russut	pärskiä
russut	purkautua
ráidejuššat	raitioida
ráttástuvvat	häkeltyä
ráttástuvvat	hermostua
seassat	tarkastella
seassat	kunnostaa
sievttastit	vokotella
sirret	eristää
sivdnidit	luoda
sivdnidit	siunata
skilkalit	kilkahduttaa
skillalahttit	kilahduttaa
skirrát	törröttää
skuožurdit	nälviä
skuvlet	kouluttaa
soabadit	sopia
sogŋostallat	kosiskella
sohpasit	kaluuntua
sotkašuvvat	vaivaantua
stulljet	ryöstökalastaa
stuđeret	opiskella
stuđeret	tutkiskella
suorganit	säikähtää
suorganit	yllättyä
suorggahit	säikäyttää
suorggahit	yllättää
surgehit	säikäyttää
surgehit	yllättää
sáddedit	lähetellä
sáddedit	sadatella
sáddehit	lähetyttää
sáddehit	kirota
sáhtašit	kyyditä
sáhtašit	saatella
sártnuhit	puhuttaa
tregget	naarata
triivet	harjoittaa
triivet	tilkitä
unnádallat	pienennellä
veanzut	vollottaa
viegahallat	juoksutella
viggat	pyrkiä
viggat	tavoitella
viidudit	laajentaa
viradit	virua
vuoladit	vuoleskella
vuoladit	höyläillä
vuollat	vuolla
vuovssihit	oksettaa
váimmoskit	sydämistyä
váimmoskit	rohkaistua
áhcagastit	hehkua
áhcagastit	hehkuttaa
áibat	viivästyä
átnuladdat	anoskella
átnuladdat	pyydellä
átnut	anoa
ávjuluvvat	huipentua
ávjuluvvat	kärjistyä
áŋgiruššat	uurastaa
áŋgiruššat	intoilla
čearguladdat	karjahdella
čeargulit	karjahtaa
čeargulit	jyrähtää
čeargut	karjua
čeargut	jyristä
čearssuhit	virnistellä
čeasihit	luiskahtaa
čerget	karjaista
čerget	jyrähtää
čielggadit	selventää
čielggadit	selvitellä
čuoččahit	pysähtyä
čuoččahit	seisahtua
čurvvodit	huudella
čáskat	sammua
čáskat	vaimeta
čávvásit	vyöryä
šelget	kirkastaa
šelget	kiillottaa
šliđardit	hutiloida
šliđardit	retalehtaa
šláddjet	lajitella
šávahit	kohistaa
šávahit	kaahata
addáladdat	anniskella
addáladdat	jaella
addáladdat	läksyttää
beakkuhit	pyydellä
bissehit	pysäyttää
bissehit	lamata
bážihit	ammuttaa
cadjat	tuupata
cadjat	tönäistä
dasadit	tuupiskella
dearistit	terittää
dearistit	terästää
doarostit	törmätä
geazadit	sonnustautua
gieldit	kieltää
gieldit	evätä
healsut	ahmia
ihttot	itää
jalggodit	tasoittua
maŋŋánit	myöhästyä
maŋŋánit	myöhentyä
mieđuštit	säestää
njovggiidit	lisääntyä
njámmasit	vyyhteytyä
rámškalit	hulmauttaa
sodnját	riippua
sodnját	roikkua
sordot	alistua
uhcáhastit	hemmotella
unnáhastit	hemmotella
vanahit	venyttää
vanahit	pitkittää
váivašuvvat	vaivaantua
váivašuvvat	vaivautua
váivašuvvat	työlästyä
váldáladdat	nappailla
váldáladdat	napsia
árrit	estää
árrit	häiritä
árrit	hätistää
čatnašuvvat	sitoutua
čatnašuvvat	liittyä
čorggodit	siistiytyä
čorggodit	puhdistua
čorggodit	kaunistua
čálihit	kirjoituttaa
čálihit	viillättää
šnjirggádit	kirkaista
šnjirggádit	kirskahtaa
šnjirggádit	hirnahtaa
šnjirgut	kimittää
šnjirgut	kirskua
šnjirgut	hirnua
bálvalit	palvella
bálvalit	mielistellä
bálvalit	orjailla
bálvalit	palvoa
cáhkit	pistää
cáhkit	työntää
cáhkit	työntyä
logahit	luettaa
suhkalit	keinahtaa
vuohčudit	erittää
čáhccet	vesittää
čáhccet	kostuttaa
čáhccet	vanuttaa
čáhccet	kastella
attástallat	sättiä
attástallat	nahistella
sugahallat	soudatella
sugahallat	keinutella
sugahit	soudattaa
sugahit	keinuttaa
guoskat	koskea
bagadallat	ohjata
šiehtadallat	neuvotella
logahallat	rekisteröidä
ásahallat	säätää
sisdoallat	sisältää
sisttisdoallat	sisältää
digaštallat	keskustella
digáštallat	keskustella
biebmat	ruokia
ilbmat	ilmestyä
soahpat	sopia
arvat	uskaltaa
geavvat	nousta
sajáiduvvat	sopeutua
ođasmuvvat	uusia
lihkostuvvat	onnistua
nuppástuvvat	muuttua
áimmahuššat	ylläpitää
ságaškuššat	keskustella
nákcet	pystyä
bivdet	pyytää
bágget	pakottaa
njulget	oikoa
čavget	kiristää
čuvget	ilmoittaa
máŋget	monistaa
suddjet	suojella
ráddjet	rajoittaa
goiket	kuivata
čohkket	kerätä
vurket	säilytä
hábmet	hahmota
reguleret	säätää
integreret	integroida
formaliseret	formalisoida
organiseret	järjestää
konkretiseret	konkretisoida
raporteret	raportoida
rekrutteret	rekrytoida
evalueret	arvioida
várret	varoittaa
stivret	hallita
dásset	tasoittaa
kártet	kartoittaa
hehttet	estää
gáhttet	katua
ráđđet	neuvoa
čuohcit	vaikuttaa
rievddadit	muuttaa
bagadit	kasvattaa
juogadit	jakaa
nammadit	nimittää
šiehtadit	sopia
buhtadit	hyvittää
eastadit	estää
buvttadit	tuottaa
geahpedit	keventää
fievrredit	kuljettaa
viiddidit	laajentaa
ovddidit	edistää
bajidit	nostaa
guhkidit	pidentää
dáhkidit	taata
vuolidit	alentaa
unnidit	vähentää
eahpidit	epäillä
geahpidit	keventää
fievrridit	kuljettaa
govvidit	kuvata
váidit	valittaa
maŋidit	lykätä
gáržžidit	rajoittaa
siskkildit	sisältää
divodit	korjata
suokkardit	tutkia
meannudit	käyttäytyä
vuođđudit	perustaa
čoavdit	ratkaista
duvdit	tuki
beaivádit	päivittää
luobahit	luopua
máhcahit	palauttaa
dagahit	aiheuttaa
vuolggahit	käynnistää
doalahit	pitää
olahit	ehtiä
gávnnahit	selvittää
ásahit	järjestää
čilgehit	selittää
vásihit	kokea
heaittihit	lopettaa
mieđihit	myöntää
jođihit	johtaa
seailluhit	säilyttää
earuhit	erottaa
vuoruhit	priorisoida
bisuhit	säilyttää
deattuhit	painottaa
muittuhit	muistuttaa
eavttuhit	ehdottaa
čuoččuhit	väittää
bálkáhit	vuokrata
váidalit	valittaa
vuolláičállit	allekirjoittaa
čuovvolit	seurata
čoahkkanit	kokoontua
hedjonit	heikentyä
ovdánit	kehittyä
geahppánit	keventyä
lassánit	lisääntyä
boktit	herättää
ovdanbuktit	esittää
ovddastit	edustaa
oasálastit	osallistua
fátmmastit	syleillä
sihkarastit	varmistaa
sihkkarastit	varmistaa
deattastit	alleviivata
ovttastit	yhdistää
váfistit	vahvistaa
dárkkistit	tarkistaa
gárvvistit	valmistaa
dávistit	vastata
einnostit	ennustaa
álkidahttit	yksinkertaistaa
movttidahttit	innoittaa
vahágahttit	vahingoittaa
gudnejahttit	kunnioittaa
ođasmahttit	päivittää
nanosmahttit	vahvistaa
ovdánahttit	kehittää
sulastahttit	muistuttaa
buohtastahttit	vertailla
ovttastahttit	yhdistää
aiddostahttit	tarkentaa
aiddostahttit	täsmentää
ráfáiduhttit	rauhoittaa
muosehuhttit	häiritä
nuppástuhttit	muuttaa
fuomášuhttit	huomauttaa
válmmaštit	valmentaa
válmmaštit	valmistaa
duođaštit	vahvistaa
bealuštit	puolustaa
heađuštit	estää
vuođuštit	perustella
ráŋggáštit	rankaista
ráŋggáštit	rangaista
hálddašit	hallita
fuomášit	huomata
dárkot	tarkistaa
rahppot	avautua
orrot	asua
gustot	pitää
njuolgut	suoristaa
rihkkut	rikkoa
unnut	vähentyä
geassut	vetää
guohtut	laidun
rievdat	muuttaa
rievdat	muuntaa
vihkkedallat	pohtia
vihkkedallat	miettiä
ávkkástallat	hyödyntää
muddet	oikoa
muddet	korjata
vuostálastit	vastustaa
vuostálastit	protestoida
sivahallat	syytellä
ájihit	viivyttää
veardádallat	vertailla
fuolastuvvat	huolestua
viegadit	juoksennella
njuikkodit	hypellä
